團	团
圞	𪢮
夢著	梦着
園	园
圓	圆
豫著稱	豫著称
圖	图
定著称	定著称
國	国
揉著称	揉著称
著緊	着紧
圍	围
將軍抽車	将军抽車
釓	钆
流著述	流著述
圇	囵
背著名	背著名
億	亿
昂著称	昂著称
於除鞬	於除鞬
釩	钒
昂著稱	昂著称
乾沓和	乾沓和
棲	栖
亂	乱
棶	梾
想著錄	想著录
著緑	着緑
棡	
髭著	髭着
扎著名	扎著名
棧	栈
亙	亘
么姨	幺姨
瞧著称	瞧著称
耀著录	耀著录
亞	亚
么姓	幺姓
爭著名	争著名
乾步	乾步
棖	枨
棗	枣
縴	纤
棟	栋
努力著录	努力著录
棄	弃
抱著	抱着
棊	棋
鴯	鸸
帶著稱	带著称
雅著述	雅著述
鴨	鸭
鴦	鸯
拉鍊	拉链
著緋	着绯
鴣	鸪
懷著述	怀著述
鴿	鸽
渴著名	渴著名
刻著	刻着
鴻	鸿
藝著書	艺著书
鴷	䴕
候著录	候著录
苦著錄	苦著录
鴰	鸹
鴉	鸦
心著称	心著称
鴇	鸨
躍著稱	跃著称
鴃	𫛞
髭著稱	髭著称
涼著者	凉著者
鴟	鸱
踩著称	踩著称
鴝	鸲
在著名	在著名
鴛	鸳
鴗	𫁡
鴕	鸵
鴒	鸰
崙	仑
疑著錄	疑著录
信著名	信著名
達著稱	达著称
制著名	制著名
乾基	乾基
躊	踌
傳著名	传著名
暗著称	暗著称
柵	栅
唱著称	唱著称
掖著录	掖著录
穿著作	穿著作
麩	麸
幫著稱	帮著称
拉著名	拉著名
踏著錄	踏著录
釒	钅
雍乾	雍乾
晶元	芯片
昂著书	昂著书
旋乾轉坤	旋乾转坤
附著书	附著书
伴著书	伴著书
榴梿	榴莲
暗著錄	暗著录
縳	䌸
忍著述	忍著述
闆	板
定著书	定著书
闃	阒
去著者	去著者
闍	阇
闌	阑
闋	阕
闊	阔
闈	闱
裹著述	裹著述
闖	闯
闕	阙
闔	阖
藏著录	藏著录
闒	阘
闐	阗
闞	阚
關	关
乾乾	乾乾
㩜	㨫
隔著書	隔著书
努力著书	努力著书
闤	阛
昂著述	昂著述
闢	辟
闡	阐
闠	阓
扛著作	扛著作
夢著稱	梦著称
乾九	乾九
達著作	达著作
靠著称	靠著称
嫻	娴
軟體	软件
打著作	打著作
於菟	於菟
猜著名	猜著名
預設	默认
紘	纮
持著称	持著称
愛著	爱着
記著者	记著者
爭著書	争著书
原著	原著
崢	峥
笑著述	笑著述
守著书	守著书
去著錄	去著录
努著述	努著述
髭著录	髭著录
渴著	渴着
紜	纭
盯著作	盯著作
沈船	沉船
藺	蔺
字母	字母
鷫	鹔
蓀	荪
爭著稱	争著称
乾贞	乾贞
矽片	硅片
蓋	盖
擺著稱	摆著称
斗著者	斗著者
扎著稱	扎著称
乘著者	乘著者
亮著称	亮著称
阿部正瞭	阿部正瞭
敞著名	敞著名
嚷著录	嚷著录
帥	帅
見著述	见著述
挑著述	挑著述
蓮	莲
蓯	苁
帶	带
帳	帐
蓴	莼
布希亞	布希亚
抓著录	抓著录
活著稱	活著称
布希亚	布希亚
蓽	荜
躺著書	躺著书
蒙著	蒙着
會	会
接著录	接著录
騙著錄	骗著录
瞞著錄	瞒著录
印著作	印著作
拉著书	拉著书
暗著稱	暗著称
康著称	康著称
落著述	落著述
朮	术
晶片	芯片
朧	胧
程式控制	程控
罩著錄	罩著录
鐵鍊	铁链
辦著稱	办著称
谐星	笑星
義	义
叱吒	叱吒
囑	嘱
留著書	留着书
變著稱	变著称
照著称	照著称
飴	饴
囈	呓
囅	冁
犯得著	犯得着
笑著書	笑著书
囂	嚣
囁	嗫
囀	啭
恩威並著	恩威并著
想著述	想著述
敞著录	敞著录
本著作	本著作
囪	囱
著綠	着绿
奈及利亞	尼日利亚
八進位制	八进位制
趴著者	趴著者
忍著書	忍著书
瞪著	瞪着
雜著述	杂著述
載著稱	载著称
麯崇裕	麯崇裕
豫著錄	豫著录
開著述	开著述
乾象	乾象
號	号
落著錄	落著录
聞	闻
幫著作	帮著作
著什么急	着什么急
溢著者	溢著者
乾氏	乾氏
薴烯	苧烯
髮	发
张法乾	张法乾
髒	脏
髖	髋
髕	髌
體	体
瞧著書	瞧着书
向著作	向著作
向著书	向著书
盾著錄	盾著录
髏	髅
羈	羁
巋	岿
背著录	背著录
看著稱	看著称
希特拉	希特勒
蔔	卜
圍著者	围著者
躺著稱	躺著称
巒	峦
想著稱	想著称
巖	岩
巔	巅
突尼西亞	突尼斯
蔥	葱
蔣	蒋
蔭	荫
巹	卺
巰	巯
福著	福着
跑著書	跑著书
趴著作	趴著作
罵著	骂着
燒	烧
燜	焖
營	营
燙	烫
燁	烨
乾鵲	乾鹊
站著錄	站著录
燉	炖
波札那	博茨瓦纳
燴	烩
燶	㶶
燼	烬
燾	焘
癲	癫
冀著錄	冀著录
燭	烛
燬	毁
裹著称	裹著称
爭著作	争著作
拋	抛
轉著錄	转著录
乾陵	乾陵
著法	着法
哭著名	哭著名
沿著书	沿著书
斬	斩
樣	样
對著述	对著述
動著	动着
逼著作	逼著作
鴴	鸻
姓幺	姓幺
么娘	幺娘
受著錄	受著录
披著書	披著书
乾陀	乾陀
泡麵	方便面
冀著录	冀著录
守著名	守著名
踏著稱	踏著称
揉著述	揉著述
活著作	活著作
丑著錄	丑著录
盛著作	盛著作
釀著錄	酿著录
變著	变着
藏著名	藏著名
聽著作	听著作
尋著述	寻著述
拿著称	拿著称
騙著作	骗著作
於夫羅	於夫罗
拚搏	拚搏
做著錄	做著录
乘著述	乘著述
美著述	美著述
鴆	鸩
著呢	着呢
閉著錄	闭著录
乾健	乾健
對著錄	对著录
循著称	循著称
哭著录	哭著录
獨著書	独著书
太閤	太阁
斥著书	斥著书
趴著錄	趴著录
磑	硙
遇著录	遇著录
去著作	去著作
磚	砖
齋	斋
高著录	高著录
骯	肮
鴞	鸮
站著名	站著名
梳著錄	梳著录
磧	碛
跪著书	跪著书
語著作	语著作
磯	矶
宏都拉斯	洪都拉斯
涼著書	凉著书
乾一壇	乾一坛
磽	硗
二極體	二极管
𨦫	䦀
踴	踊
旋乾转坤	旋乾转坤
閨	闺
乾蔭	乾荫
亮著者	亮著者
跳著录	跳著录
含著錄	含著录
雅著作	雅著作
瞞著名	瞒著名
擺著	摆着
杴	锨
戴著录	戴著录
駕著作	驾著作
幫著者	帮著者
許	许
門	门
丑著	丑着
唱著录	唱著录
訴	诉
註	注
診	诊
閎	闳
閏	闰
閈	闬
衞生	卫生
開	开
閔	闵
訢	䜣
猜著称	猜著称
閑	闲
訥	讷
間	间
訪	访
訩	讻
閘	闸
設	设
訓	训
閥	阀
訑	𫍙
訐	讦
託	托
訖	讫
訕	讪
閣	阁
訛	讹
閭	闾
記	记
訟	讼
閩	闽
訝	讶
閫	阃
訃	讣
訂	订
訁	讠
打著录	打著录
閱	阅
閲	阅
閼	阏
訊	讯
閾	阈
計	计
閹	阉
訌	讧
趴著	趴着
寶獅	标志
貼	贴
乘著稱	乘著称
鷁	鹢
擺著作	摆著作
連著稱	连著称
見著作	见著作
𤪺	㻘
拎著錄	拎著录
抓著述	抓著述
費	费
鍊鎖	链锁
保障著	保障着
涵著稱	涵著称
貺	贶
雜著者	杂著者
踩著錄	踩著录
傢俬	傢俬
壓著作	压著作
護著稱	护著称
隔著称	隔著称
浮著稱	浮著称
乾道	乾道
忍著作	忍著作
福著称	福著称
貰	贳
高著者	高著者
著名	著名
印著	印着
穿著錄	穿著录
於夫罗	於夫罗
溢著錄	溢著录
困著作	困著作
來著作	来著作
追著名	追著名
索羅門群島	所罗门群岛
蕆	蒇
蕁	荨
嶁	嵝
蕎	荞
彰明較著	彰明较著
著筆	着笔
做著名	做著名
嶇	岖
蕕	莸
蕒	荬
蕓	芸
暗著書	暗著书
蕘	荛
嶗	崂
蕢	蒉
嶠	峤
蕭	萧
嶢	峣
蕩	荡
蕪	芜
嶧	峄
嶸	嵘
嶺	岭
蕷	蓣
嶼	屿
遠著錄	远著录
厄瓜多爾	厄瓜多尔
嶴	岙
乾德	乾德
活著者	活著者
嚙	啮
嚕	噜
嚐	尝
嚌	哜
躍著作	跃著作
圍著作	围著作
嚇	吓
嚀	咛
楊幺	杨幺
光著書	光著书
隔著	隔着
嚴	严
嚶	嘤
嚲	亸
嚳	喾
嚮	向
抓著錄	抓著录
嚨	咙
嚥	咽
嚦	呖
罵著作	骂著作
繞著名	绕著名
桿	杆
幺氏	幺氏
甘比亞	冈比亚
抱著名	抱著名
空著书	空著书
坐著录	坐著录
燒著名	烧著名
騙著稱	骗著称
沿著录	沿著录
丑著录	丑著录
三極體	三极管
循著	循着
漫著作	漫著作
𤫩	㻏
鰾	鳔
較著	较著
牽著錄	牵著录
求著	求着
陪著錄	陪著录
釀著	酿着
纏著錄	缠著录
附著者	附著者
拖著名	拖著名
著甚	着甚
著生	着生
拼著称	拼著称
跪著录	跪著录
笑著	笑着
冀著名	冀著名
汶萊	文莱
求著錄	求著录
撼著名	撼著名
圍著名	围著名
瞪著書	瞪著书
甜著书	甜著书
驥	骥
驤	骧
護著	护着
驦	骦
於志賀	於志贺
驢	驴
睡著錄	睡著录
驫	骉
驪	骊
驕	骄
驗	验
隱睪	隱睾
努力著稱	努力著称
驟	骤
碭	砀
驛	驿
碩	硕
驅	驱
驄	骢
跑著录	跑著录
驁	骜
驀	蓦
驃	骠
驂	骖
著題	着题
驌	骕
碼	码
確	确
拉著稱	拉著称
碸	砜
驊	骅
阿拉伯聯合大公國	阿拉伯联合酋长国
掙著	挣着
昂著名	昂著名
熒	荧
得著述	得著述
斥著錄	斥著录
望著作	望著作
跳著稱	跳著称
牽著稱	牵著称
奮	奋
甜著录	甜著录
熅	煴
熾	炽
熲	颎
熱	热
哭著者	哭著者
撼著稱	撼著称
辦著錄	办著录
臨著者	临著者
衣著名	衣著名
詰	诘
中樂	民乐
該	该
詳	详
詵	诜
乾仪	乾仪
巨著	巨著
志著錄	志著录
黏著称	黏著称
詿	诖
詠	咏
坐著稱	坐著称
詢	询
詣	诣
試	试
颱	台
住著书	住著书
詩	诗
詫	诧
詬	诟
短訊	短信
詮	诠
詐	诈
詒	诒
孤著名	孤著名
詔	诏
評	评
詖	诐
詗	诇
詘	诎
詛	诅
詞	词
詁	诂
記著錄	记著录
光碟	光盘
詆	诋
猜著述	猜著述
膠著	胶着
長	长
榿	桤
乾闼	乾闼
么媽	幺妈
榲	榅
榮	荣
提著录	提著录
乾闥	乾闼
榦	干
捆著	捆着
挑著称	挑著称
襤	褴
逆著录	逆著录
夜学	夜校
騙著述	骗著述
衣著書	衣著书
暗著述	暗著述
性著稱	性著称
可穿著	可穿著
盾著述	盾著述
捆著作	捆著作
薺	荠
敞著稱	敞著称
疑著	疑着
做著书	做著书
跑著稱	跑著称
代表著书	代表著书
尋著作	寻著作
拼著錄	拼著录
鷚	鹨
獨著	独着
吹著作	吹著作
鋪著	铺着
悞	悮
幫著錄	帮著录
偷著称	偷著称
悅	悦
於乙宇同	於乙宇同
網路	网络
悶	闷
悵	怅
拉著述	拉著述
皺著作	皱著作
跳著书	跳著书
𨧜	䦁
乾灵	乾灵
樂著者	乐著者
章節附註	尾注
住著名	住著名
噥	哝
噦	哕
坐著书	坐著书
噯	嗳
噲	哙
噴	喷
噹	当
噸	吨
借著述	借著述
跡	迹
藉機	借机
噁	恶
動著稱	动著称
尼乾陀	尼乾陀
忍著称	忍著称
仗著	仗着
裹著书	裹著书
在著錄	在著录
聽著名	听著名
髭著錄	髭著录
噚	㖊
噝	咝
格瑞那達	格林纳达
黏著稱	黏著称
誶	谇
打著書	打著书
誰	谁
藝著作	艺著作
課	课
誼	谊
調	调
誾	訚
誹	诽
誥	诰
誤	误
誦	诵
誡	诫
誠	诚
誣	诬
順著述	顺著述
説	说
幺孃	幺娘
誨	诲
說	说
誕	诞
誑	诳
丑著者	丑著者
誒	诶
語	语
誘	诱
誚	诮
誅	诛
誄	诔
誇	夸
誆	诓
逆著书	逆著书
認	认
誌	志
扛著稱	扛著称
巨集	宏
乾貞	乾贞
去著	去着
站著书	站著书
殺著述	杀著述
用著录	用著录
男爲乾	男为乾
扛著录	扛著录
闥	闼
映著者	映著者
鄰	邻
與著稱	与著称
趴著稱	趴著称
非同步	异步
急著录	急著录
鍊錘	链锤
乾貺	乾贶
潯	浔
片語	词组
嗅得著	嗅得着
用著書	用著书
薈	荟
薊	蓟
薌	芗
薀	蕰
想著	想着
薘	荙
落著名	落著名
薟	莶
點著稱	点著称
薑	姜
嵗	岁
陽爲乾	阳为乾
嵐	岚
薩	萨
夢著書	梦著书
薦	荐
活著称	活著称
斗著书	斗著书
照著述	照著述
薳	䓕
薴	苧
著藁	着藁
灝	灏
霽	霁
關著名	关著名
灘	滩
保障著書	保障著书
灕	漓
梳著名	梳著名
拖著稱	拖著称
乾為天	乾为天
枕著者	枕著者
灄	滠
灃	沣
努著录	努著录
災	灾
揉著作	揉著作
孤著者	孤著者
管著名	管著名
抱著者	抱著者
灧	滟
流著者	流著者
灤	滦
灣	湾
灠	漤
拖著录	拖著录
嘮	唠
嘯	啸
嘩	哗
嘵	哓
嘰	叽
渴著称	渴著称
衣著者	衣著者
忍著錄	忍著录
嘽	啴
拿著述	拿著述
嘸	呒
矽肺	矽肺
嘆	叹
豎著名	竖著名
著書立說	著书立说
嘍	喽
膠著者	胶著者
嘖	啧
嘗	尝
嘔	呕
連著書	连著书
塞拉利昂	塞拉利昂
著抹	着抹
癧	疬
踏著称	踏著称
躍著述	跃著述
槳	桨
擋著述	挡著述
心著書	心著书
槨	椁
著録	着録
槤	梿
槧	椠
盯著錄	盯著录
著錄	着录
克羅埃西亞	克罗地亚
本著者	本著者
槓	杠
借著	借着
槍	枪
臨著述	临著述
辦著作	办著作
構	构
本著录	本著录
去著述	去著述
騸	骟
騾	骡
筍	笋
轉著名	转著名
騰	腾
騶	驺
騷	骚
騫	骞
騮	骝
騭	骘
騠	𫘨
衣索比亞	埃塞俄比亚
騧	䯄
騤	骙
美著錄	美著录
嫿	婳
騙	骗
筧	笕
著人	着人
拉著称	拉著称
騎	骑
騏	骐
騌	骔
壓著述	压著述
聽不著	听不着
騃	𫘤
近角聰信	近角聪信
騁	骋
遇著書	遇著书
穿著书	穿著书
灑	洒
睡著稱	睡著称
著跡	着迹
維德角	佛得角
塤	埙
語著述	语著述
保護著	保护着
嫵	妩
信著書	信著书
膠著作	胶著作
沉著者	沉著者
人工智慧	人工智能
發	发
斥著述	斥著述
惻	恻
惡	恶
懷著	怀着
豫著录	豫著录
廠	厂
展著錄	展著录
辭彙	词汇
瀝	沥
瀟	潇
瀘	泸
黏著名	黏著名
瀕	濒
抬著录	抬著录
瀏	浏
瀉	泻
瀋	沈
瀅	滢
瀆	渎
苦著	苦着
順著名	顺著名
瀾	澜
代表著錄	代表著录
倉	仓
瀰	弥
瀲	潋
瞭望	瞭望
瀨	濑
瀦	潴
瀧	泷
瀠	潆
么叔	幺叔
諺	谚
鋒	锋
諸	诸
努力著作	努力著作
諼	谖
著床	着床
諳	谙
鋙	铻
諱	讳
鋟	锓
諷	讽
賴比瑞亞	利比里亚
乾县	乾县
跟著	跟着
諫	谏
鋁	铝
鋇	钡
鋅	锌
諭	谕
諢	诨
李乾顺	李乾顺
鋏	铗
諧	谐
諤	谔
鋌	铤
諛	谀
鋱	铽
魚乾乾	鱼干干
諞	谝
鋶	锍
諜	谍
試著錄	试著录
諒	谅
鋸	锯
涵著名	涵著名
諗	谂
鋼	钢
鋣	铘
請	请
諉	诿
諏	诹
鋥	锃
諍	诤
諂	谄
睡著书	睡著书
鋩	铓
鋨	锇
陪著者	陪著者
鋮	铖
流動電話	移动电话
叫著录	叫著录
著涼	着凉
管著稱	管著称
展著称	展著称
披著作	披著作
圍著	围着
涵著	涵着
因著	因着
釀著稱	酿著称
乾儀	乾仪
鋪著稱	铺著称
寫著述	写著述
心著名	心著名
塚	冢
揮著作	挥著作
字元会	字元会
沙地阿拉伯	沙特阿拉伯
裹著名	裹著名
藎	荩
藍	蓝
崗	岗
著絲	着丝
著落	着落
有著書	有著书
悠著稱	悠著称
用著	用着
藝	艺
著節	着节
塔吉克	塔吉克斯坦
崍	崃
纏著	缠着
藪	薮
藥	药
閉著書	闭著书
汙	污
空著	空着
藹	蔼
藶	苈
晃著录	晃著录
藴	蕴
用不著	用不着
崬	岽
借著錄	借著录
待著称	待著称
有著者	有著者
斥著稱	斥著称
衣著书	衣著书
遷	迁
踩著稱	踩著称
拉著作	拉著作
因著称	因著称
於乙于同	於乙于同
遠著書	远著书
裝著名	装著名
衣著	衣着
丑著書	丑著书
印著书	印著书
嗩	唢
在著書	在著书
嗹	𪡏
哭著书	哭著书
趕著	赶着
嗶	哔
嗊	唝
乾罗	乾罗
嗎	吗
嗇	啬
嗆	呛
追著書	追著书
嗚	呜
懷著稱	怀著称
數著稱	数著称
皺著述	皱著述
兩	两
躺著錄	躺著录
𩣑	䯃
師	师
涵著者	涵著者
撼著录	撼著录
涵著称	涵著称
𩣵	𩧻
著疑	着疑
來著名	来著名
本著稱	本著称
遙	遥
遠著名	远著名
鯿	鳊
鯽	鲫
踏著名	踏著名
坐著書	坐著书
鯴	鲺
吹著述	吹著述
鯰	鲇
鯫	鲰
鯪	鲮
鯨	鲸
鯧	鲳
鯤	鲲
鯢	鲵
鯡	鲱
鯝	鲴
鯛	鲷
順著錄	顺著录
鯗	鲞
鯖	鲭
鯕	鲯
鯔	鲻
鯒	鲬
麽麽	麽麽
亞塞拜然	阿塞拜疆
鯊	鲨
鯉	鲤
鯇	鲩
鯆	𫚙
記著作	记著作
鯁	鲠
鯀	鲧
䉬	𫂈
夥計	伙计
舘	馆
與	与
志著录	志著录
應著書	应著书
舊	旧
舉	举
興	兴
領著名	领著名
島	岛
陳禕	陳禕
峴	岘
峽	峡
疑著称	疑著称
著著	着着
印著名	印著名
乾沓婆	乾沓婆
矽鋼	矽钢
辛巴威	津巴布韦
於于同	於于同
米泽瑠美	米泽瑠美
苦著书	苦著书
蟻	蚁
存摺	存摺
烴	烃
走著书	走著书
瞪著名	瞪著名
候著述	候著述
拎著	拎着
味著書	味著书
論著	论著
臨著	临着
烏	乌
趴著书	趴著书
榴槤	榴莲
滷	卤
閉著名	闭著名
盾著书	盾著书
展著稱	展著称
走著录	走著录
福著錄	福著录
浮著名	浮著名
乾樞	乾枢
陪著作	陪著作
苦著录	苦著录
欄位	字段
軟碟機	软驱
敞著錄	敞著录
響著稱	响著称
演著书	演著书
本著书	本著书
鐃	铙
趕著錄	赶著录
殺著	杀着
逼著书	逼著书
沿著作	沿著作
全形	全角
跑著錄	跑著录
瞧著錄	瞧著录
騎著述	骑著述
椏	桠
著淺	着浅
盛著	盛着
乾兴	乾兴
著作	著作
接著者	接著者
罩著称	罩著称
劚	㔉
乾元	乾元
行著书	行著书
幺叔	幺叔
對著稱	对著称
活著錄	活著录
看著录	看著录
流著書	流著书
聽著稱	听著称
映著作	映著作
篋	箧
範	范
鮶	鲪
鮰	𫚔
節	节
鮳	鲓
鮭	鲑
鮮	鲜
鮪	鲔
鮫	鲛
篔	筼
鮦	鲖
哭著錄	哭著录
含著述	含著述
趴著录	趴著录
鮝	鲞
鮞	鲕
篩	筛
幺鳳	幺凤
鮚	鲒
斥著作	斥著作
篤	笃
鮐	鲐
衣索匹亞	埃塞俄比亚
鮒	鲋
鮓	鲊
鮍	鲏
鮎	鲇
鮊	鲌
鮋	鲉
鮄	𫚒
浮著录	浮著录
鮁	鲅
篳	筚
鮃	鲆
沉著錄	沉著录
抬著稱	抬著称
追著者	追著者
麗著述	丽著述
雅著书	雅著书
曨	昽
殺著者	杀著者
數著	数着
鰳	鳓
用著稱	用著称
乾光	乾光
恥	耻
謾	谩
蒲隆地	布隆迪
伯利茲	伯利兹
冀著作	冀著作
謹	谨
銘	铭
銚	铫
銛	铦
謳	讴
銀	银
曠	旷
謭	谫
謬	谬
謫	谪
銅	铜
遠著述	远著述
謨	谟
匯流排	总线
銍	铚
謡	谣
謠	谣
銱	铞
謝	谢
銳	锐
講	讲
謚	谥
謙	谦
銷	销
謗	谤
謖	谡
謔	谑
銼	锉
謐	谧
謏	𫍲
謎	谜
𧝞	䘛
銣	铷
謊	谎
銦	铟
沈積	沉积
銨	铵
銩	铥
謅	诌
謄	誊
銬	铐
謂	谓
謁	谒
謀	谋
鰂	鲗
僧伽吒	僧伽吒
寀	采
裝著稱	装著称
瞪著稱	瞪著称
鰁	鳈
演著稱	演著称
達著	达着
涵著述	涵著述
考著名	考著名
寢	寝
寧	宁
實	实
寫	写
愛著稱	爱著称
萬那杜	瓦努阿图
永曆	永历
乾贶	乾贶
囌	苏
樂著述	乐著述
寶	宝
寵	宠
乙太網	以太网
身著称	身著称
么孃	幺娘
忍著书	忍著书
舒麥加	迈克尔·舒马赫
跪著作	跪著作
領著	领着
楊	杨
吉布地	吉布提
乾务	乾务
幺厮	幺厮
楓	枫
趕著名	赶著名
築	筑
鰍	鳅
看著錄	看著录
乾钧	乾钧
乾劉	乾刘
伴著書	伴著书
業	业
硬碟	硬盘
閻懷禮	闫怀礼
楨	桢
撾	挝
極	极
躺著称	躺著称
艙	舱
待著書	待著书
黛安娜	戴安娜
閉著述	闭著述
朝著稱	朝著称
瞞著作	瞒著作
艱	艰
鳾	䴓
艷	艳
困著书	困著书
考著录	考著录
於崇文	於崇文
艤	舣
岡	冈
艦	舰
艫	舻
賴索托	莱索托
晃著	晃着
卷舌	卷舌
喪	丧
喫	吃
喬	乔
單	单
麴義	麴义
喝著称	喝著称
颭	飐
動著者	动著者
乾泉水	干泉水
叫著作	叫著作
低著錄	低著录
梳著称	梳著称
喲	哟
夾著者	夹著者
響著作	响著作
撓	挠
扛著錄	扛著录
喎	㖞
牽著作	牵著作
士多啤梨	草莓
跟著稱	跟著称
喚	唤
乾羅	乾罗
串列	串行
近角聪信	近角聪信
鷂	鹞
燒著錄	烧著录
浮著者	浮著者
聞不著	闻不着
乾構	乾构
住著錄	住著录
臨著作	临著作
得著录	得著录
䰾	鲃
黏著書	黏著书
二進位制	二进位制
學著者	学著者
著趣	着趣
循著作	循著作
睪丸	睾丸
疑著作	疑著作
辦著述	办著述
戰著書	战著书
睡得著	睡得着
信著书	信著书
鮑	鲍
困著名	困著名
戴著錄	戴著录
慣著錄	惯著录
映著稱	映著称
吹著称	吹著称
天道为乾	天道为乾
麴义	麴义
藉手	借手
美著	美着
滑鼠蛇	滑鼠蛇
緘	缄
編著	编著
周易乾	周易乾
印著稱	印著称
連著名	连著名
蒙著作	蒙著作
騙著	骗着
銥	铱
鳶	鸢
箇	个
因著书	因著书
箋	笺
厄利垂亞	厄立特里亚
有著錄	有著录
追著书	追著书
箏	筝
落著录	落著录
乾红	乾红
著魔	着魔
陋著述	陋著述
瑤	瑶
甜著作	甜著作
晃著錄	晃著录
急著作	急著作
刻著称	刻著称
梳著	梳着
仗著錄	仗著录
夢著作	梦著作
藝著述	艺著述
載入	加载
演算法	算法
為	为
饃	馍
康乾	康乾
乾為陽	乾为阳
留著录	留著录
單車	自行车
於梨华	於梨华
福著录	福著录
皺著	皱着
鉕	钷
譽	誉
努力著述	努力著述
譸	诪
乾定	乾定
繫	系
護	护
議	议
挨著稱	挨著称
鉛	铅
鉚	铆
鉅	钜
譭	毁
乾宁	乾宁
乾宇	乾宇
乾宅	乾宅
鉍	铋
𧜵	䙊
乾安	乾安
幺媽	幺妈
鉈	铊
鉋	铇
頂著者	顶著者
布吉納法索	布基纳法索
鉶	铏
識	识
譙	谯
譚	谭
譖	谮
制著書	制著书
鉻	铬
戰著名	战著名
鉤	钩
譎	谲
譏	讥
證	证
譊	𫍢
鉢	钵
鉭	钽
譅	䜧
朴於宇同	朴於宇同
天道為乾	天道为乾
唱著述	唱著述
乾一組	乾一组
蘸著称	蘸著称
載著作	载著作
爭著者	争著者
雅著錄	雅著录
有著名	有著名
騎著者	骑著者
伴著作	伴著作
偷著名	偷著名
恆	恒
載著者	载著者
鮜	鲘
性著	性着
掄	抡
答覆	答复
揉著稱	揉著称
配著名	配著名
因著名	因著名
檉	柽
拼著者	拼著者
於乎	於乎
沉著	沉着
檁	檩
么氏	幺氏
記著述	记著述
檟	槚
檜	桧
溢著稱	溢著称
附著	附着
照著作	照著作
檯	台
檮	梼
美著名	美著名
檣	樯
檢	检
學著錄	学著录
檻	槛
印著录	印著录
檸	柠
乾務	乾务
李澤鉅	李泽钜
檳	槟
身著作	身著作
鳬	凫
玩著	玩着
背著	背着
憚	惮
動著名	动著名
憒	愦
憑	凭
憐	怜
乾岗	乾岗
憊	惫
魘	魇
魛	鱽
魚	鱼
憂	忧
魟	𫚉
么鳳	幺凤
魢	鱾
躺著述	躺著述
乾岡	乾冈
著艦	着舰
魨	鲀
蘸著书	蘸著书
憲	宪
魯	鲁
伺服器	服务器
憮	怃
憫	悯
魴	鲂
魷	鱿
盞	盏
躍著名	跃著名
憤	愤
著手	着手
坐著錄	坐著录
啢	唡
看不著	看不着
動著述	动著述
困著稱	困著称
跟著称	跟著称
問	问
本著名	本著名
啟	启
啞	哑
豎著稱	竖著称
啓	启
沿著述	沿著述
挨著称	挨著称
鈞	钧
著志	着志
配著錄	配著录
鈒	钑
鈐	钤
著忙	着忙
開著	开着
鈕	钮
鏗	铿
著心	着心
鈈	钚
銓	铨
鈎	钩
乘著录	乘著录
鈍	钝
鈃	钘
鈀	钯
鈁	钫
鈇	𫓧
鈄	钭
鈺	钰
鈸	钹
鈹	铍
鈾	铀
鈿	钿
藉著	借着
鈽	钸
鈳	钶
鈰	铈
鈷	钴
鈴	铃
李乾德	李乾德
演著者	演著者
鈮	铌
乾寧	乾宁
傳著錄	传著录
鈣	钙
鈦	钛
鈧	钪
鈥	钬
讀	读
獨著作	独著作
挨著名	挨著名
瘲	疭
銜	衔
變	变
讎	仇
讓	让
讒	谗
讕	谰
讖	谶
印著者	印著者
讚	赞
讜	谠
蘸著書	蘸著书
讞	谳
枕著稱	枕著称
孫	孙
性著作	性著作
逆著	逆着
戀著	恋着
尋著名	寻著名
孿	孪
學	学
抬著者	抬著者
屜	屉
反反覆覆	反反复复
接著稱	接著称
易經乾	易经乾
屍	尸
揉著錄	揉著录
屆	届
潤著者	润著者
受著者	受著者
載著書	载著书
芻	刍
屩	𪨗
屨	屦
陪著述	陪著述
屬	属
屢	屡
绑紧跳	蹦极跳
層	层
獫	猃
獪	狯
繞著述	绕著述
獨	独
獮	狝
厭	厌
騎著錄	骑著录
李乾順	李乾顺
獻	献
獺	獭
揉著书	揉著书
獸	兽
獼	猕
獲	获
獱	㺍
獰	狞
獷	犷
福著者	福著者
獵	猎
獎	奖
葛摩	科摩罗
撼著称	撼著称
獃	呆
獁	犸
努力著名	努力著名
獅	狮
獄	狱
行著录	行著录
銹	锈
名著	名著
銻	锑
應著名	应著名
土著	土著
賵	赗
著文	著文
躊躇滿志	踌躇滿志
乾縣	乾县
聽著者	听著者
於姓	於姓
住著	住着
心著录	心著录
性著述	性著述
唚	吣
拚死	拚死
綁著述	绑著述
擋著稱	挡著称
男性为乾	男性为乾
唄	呗
瞞著	瞒着
急著者	急著者
終	终
絀	绌
聖吉斯納域斯	圣基茨和尼维斯
絆	绊
絅	䌹
組	组
來著稱	来著称
藝著名	艺著名
結	结
借著者	借著者
絛	绦
絞	绞
絝	绔
逼著	逼着
絢	绚
絡	络
銫	铯
給	给
絨	绒
絳	绛
絲	丝
統	统
絰	绖
絶	绝
活著	活着
絺	𫄨
絹	绢
瞪著述	瞪著述
待著錄	待著录
跪著述	跪著述
住著書	住著书
備著錄	备著录
豫著名	豫著名
蒙著录	蒙著录
蔞	蒌
穎	颖
積	积
穌	稣
含著作	含著作
變著述	变著述
於宇同	於宇同
忙著	忙着
標志著	标志着
擋著	挡着
語著稱	语著称
穢	秽
穡	穑
穠	秾
穭	稆
候著称	候著称
穫	获
穩	稳
鬆	松
懞	蒙
懟	怼
扛著书	扛著书
蔦	茑
賕	赇
叢	丛
低著稱	低著称
揉著名	揉著名
捆著称	捆著称
懍	懔
斥著称	斥著称
節慶	节日
盛著名	盛著名
應	应
懇	恳
鬚	须
懼	惧
漫著	漫着
懾	慑
鬥	斗
鬢	鬓
懺	忏
尋著	寻着
懶	懒
逕	迳
躺著者	躺著者
懲	惩
鬩	阋
懨	恹
瞪著作	瞪著作
試著稱	试著称
鬱	郁
揮著名	挥著名
懣	懑
獨著者	独著者
偷著录	偷著录
屋价	房价
著鞭	着鞭
猻	狲
介面	接口
猶	犹
頂著錄	顶著录
亮著作	亮著作
猙	狰
駕著者	驾著者
遇著名	遇著名
罩著書	罩著书
冒著書	冒著书
鏟	铲
鏞	镛
鏝	镘
鏜	镗
鏚	戚
鏘	锵
信著者	信著者
16進位	16进位
考著稱	考著称
渴著錄	渴著录
鏑	镝
鏐	镠
鏍	镙
鏌	镆
鏈	链
鏇	镟
鏃	镞
疑著名	疑著名
远程控制	远程控制
鏽	锈
配著者	配著者
隔著录	隔著录
鏹	镪
鏷	镤
鏵	铧
愛著名	爱著名
鏰	镚
幺娘	幺娘
拎著称	拎著称
睡著作	睡著作
騎著稱	骑著称
鏦	𫓩
鏤	镂
傳著述	传著述
審	审
鏡	镜
守著作	守著作
跑著称	跑著称
哭著稱	哭著称
櫃	柜
櫚	榈
櫛	栉
櫝	椟
櫞	橼
櫟	栎
櫓	橹
蟬	蝉
孤著书	孤著书
疑著述	疑著述
空著者	空著者
櫫	橥
櫬	榇
乾鵠	乾鹄
櫥	橱
櫧	槠
櫸	榉
乾刚	乾刚
櫻	樱
性著名	性著名
傳著	传着
揮著	挥着
櫳	栊
奐	奂
導	导
對	对
見著名	见著名
尋	寻
專	专
將	将
沉著稱	沉著称
殺著錄	杀著录
疑著稱	疑著称
尷	尴
開著書	开著书
用著述	用著述
盯著称	盯著称
綁著者	绑著者
康著錄	康著录
苧	苎
流著稱	流著称
乾封	乾封
飈	飚
拿著作	拿著作
貞著述	贞著述
愨	悫
伴著录	伴著录
飀	飗
飆	飙
飄	飘
飛	飞
忙著录	忙著录
愴	怆
愷	恺
扎著录	扎著录
愾	忾
飫	饫
飪	饪
飩	饨
飯	饭
喝著錄	喝著录
飭	饬
三極管	三极管
飢	饥
衣著作	衣著作
飠	饣
著墨	着墨
飥	饦
燈	灯
速食麵	方便面
看著	看着
鈔	钞
飿	饳
飾	饰
飽	饱
飼	饲
飲	饮
飱	飧
捆著述	捆著述
愜	惬
於潛縣	於潜县
蟎	螨
裝著書	装著书
劉	刘
陪著	陪着
流著	流着
動著作	动著作
學著作	学著作
平治	奔驰
乾清宫	乾清宫
浮著述	浮著述
乾清宮	乾清宫
試著	试着
得著稱	得著称
嚷著名	嚷著名
覆蓋	覆蓋
丑著称	丑著称
嬋	婵
嬈	娆
拉著書	拉著书
衹	只
嬌	娇
嬀	妫
愛著者	爱著者
嬙	嫱
逆著称	逆著称
易經·乾	易经·乾
鍤	锸
嬪	嫔
沉著述	沉著述
嬡	嫒
嬤	嬷
嬸	婶
燦	灿
配著稱	配著称
罩著者	罩著者
嬰	婴
甜著述	甜著述
唱著者	唱著者
展著名	展著名
稜	棱
稟	禀
甚麼	什么
甚麽	什么
稅	税
獲著錄	获著录
稏	䅉
稈	秆
映著录	映著录
跑著述	跑著述
稱	称
當著錄	当著录
鍰	锾
福著作	福著作
急著述	急著述
耀著名	耀著名
受著稱	受著称
著式	着式
種	种
掙著作	挣著作
康著书	康著书
繞著作	绕著作
反覆	反复
空著錄	空著录
吉里巴斯	基里巴斯
參	参
儲	储
叄	叁
麼麼	麽麽
茲	兹
陋著書	陋著书
遇著稱	遇著称
沿著者	沿著者
背著述	背著述
儷	俪
䯀	䯅
保障著稱	保障著称
現	现
儻	傥
儸	㑩
暗著书	暗著书
磁碟	磁盘
附著述	附著述
沉著作	沉著作
苦著作	苦著作
乾和	乾和
紀	纪
紂	纣
約	约
紅	红
紆	纡
紇	纥
陪著书	陪著书
紉	纫
紋	纹
納	纳
紐	纽
找得著	找得着
紓	纾
純	纯
紕	纰
紖	纼
紗	纱
做著述	做著述
紙	纸
級	级
紛	纷
管著錄	管著录
紝	纴
紡	纺
暗著名	暗著名
紬	䌷
紮	扎
細	细
紱	绂
紲	绁
紳	绅
紵	纻
光著书	光著书
紹	绍
紺	绀
紼	绋
紿	绐
行著作	行著作
有著述	有著述
跪著称	跪著称
不著痕跡	不着痕迹
樅	枞
抱著稱	抱著称
樁	桩
樂	乐
樞	枢
標	标
扎著作	扎著作
么小	幺小
挑著名	挑著名
樑	梁
望著称	望著称
樓	楼
戴著述	戴著述
閑著錄	闲著录
幫著名	帮著名
𧦧	𫍟
乾剛	乾刚
借著书	借著书
循著書	循著书
制著录	制著录
樹	树
樸	朴
樺	桦
滾	滚
坦尚尼亞	坦桑尼亚
涵著錄	涵著录
竈	灶
竊	窃
藉端	借端
信著作	信著作
竅	窍
竄	窜
竇	窦
綏	绥
镟	旋
滄	沧
衛生	卫生
跑著者	跑著者
站著書	站著书
競	竞
臨著名	临著名
映著书	映著书
竪	竖
與著名	与著名
抓著者	抓著者
心著作	心著作
慤	悫
背著作	背著作
盾著作	盾著作
慮	虑
乾居	乾居
慪	怄
慫	怂
萧乾	萧乾
慶	庆
慳	悭
慾	欲
釀著書	酿著书
不著邊際	不着边际
風	风
慄	栗
駕著名	驾著名
區域網	局域网
颮	飑
颯	飒
挑著录	挑著录
慍	愠
態	态
颸	飔
許可權	权限
颺	飏
颻	飖
颼	飕
慟	恸
獨著稱	独著称
慚	惭
慘	惨
鎝	𨱏
鎘	镉
鎚	锤
鎛	镈
鎔	镕
遇著述	遇著述
鎖	锁
借著名	借著名
豎著	竖着
鎌	镰
走著作	走著作
鎊	镑
㠏	㟆
鎄	锿
鎇	镅
雅著	雅着
鎂	镁
鎿	镎
鎸	镌
提著述	提著述
鎵	镓
鎰	镒
鎲	镋
鎳	镍
鎬	镐
鎭	鎮
鎮	镇
冀著书	冀著书
鎩	铩
鎪	锼
含著名	含著名
豫著述	豫著述
鎦	镏
鎧	铠
鎡	镃
鎢	钨
鎣	蓥
蠍	蝎
蘸著者	蘸著者
蠆	虿
蠅	蝇
蠟	蜡
仗著者	仗著者
性著者	性著者
嫗	妪
愛著述	爱著述
蠑	蝾
蠐	蛴
覆核	复核
蠨	蟏
蠣	蛎
冒著书	冒著书
蠻	蛮
住著录	住著录
站著稱	站著称
逆著述	逆著述
蠱	蛊
試著書	试著书
望著述	望著述
蠶	蚕
揉著录	揉著录
夾著書	夹著书
連著錄	连著录
機	机
枕著作	枕著作
守著錄	守著录
橋	桥
橈	桡
孤著	孤着
瞪著錄	瞪著录
站著录	站著录
孤著述	孤著述
橢	椭
記著稱	记著称
橫	横
網際網路	互联网
厠	厕
簡	简
厤	历
乾维	乾维
漫著稱	漫著称
樂著	乐着
伴著稱	伴著称
網	网
厲	厉
厴	厣
荊	荆
繞著	绕着
綰	绾
著祂	着祂
著氣	着气
據著稱	据著称
受著	受着
盾著	盾着
厙	厍
用著名	用著名
站著	站着
咼	呙
斥著	斥着
著火	着火
候著	候着
尋著者	寻著者
當著述	当著述
盾著稱	盾著称
想著者	想著者
獲著述	获著述
叫著书	叫著书
藏著書	藏著书
叫著称	叫著称
福斯	大众
石碁鎮	石碁镇
吹著書	吹著书
行著述	行著述
涼著名	凉著名
象牙海岸	科特迪瓦
著我	着我
記著	记着
緄	绲
緇	缁
備著作	备著作
燒著作	烧著作
嚷著称	嚷著称
猜著作	猜著作
緋	绯
緊	紧
字元	字符
緔	绱
緗	缃
緑	绿
緓	绬
緒	绪
緝	缉
緞	缎
緙	缂
獨著名	独著名
線	线
配著書	配著书
緦	缌
緡	缗
締	缔
緣	缘
緬	缅
緯	纬
緩	缓
編	编
練	练
緶	缏
緱	缑
乾纲	乾纲
緲	缈
乾纽	乾纽
緹	缇
乾棟	乾栋
緻	致
鱨	鲿
衊	蔑
慣著名	惯著名
味著	味着
晃著述	晃著述
潤著錄	润著录
衆	众
乾軸	乾轴
衚	胡
衛	卫
衝	冲
忍著名	忍著名
米高奧雲	迈克尔·欧文
術	术
衕	同
16進位制	16进位制
斗著	斗着
幺麽小丑	幺麽小丑
乾車	乾车
媯	妫
冒著	冒着
媧	娲
跳著名	跳著名
媼	媪
媽	妈
向著書	向著书
走著称	走著称
盛著称	盛著称
夾著	夹着
飄著稱	飘著称
氆氌	氆氌
黏著	黏着
髭著称	髭著称
綁著錄	绑著录
急著书	急著书
獲著書	获著书
用著书	用著书
窺	窥
窶	窭
追著作	追著作
窵	窎
仗著书	仗著书
窮	穷
窯	窑
窪	洼
考著作	考著作
管著录	管著录
窩	窝
位元組	字节
乾矢	乾矢
渴著者	渴著者
尋著稱	寻著称
摟著錄	搂著录
靠著錄	靠著录
暗著录	暗著录
醯壺	醯壶
拼著稱	拼著称
氾濫	泛滥
望著名	望著名
圍著錄	围著录
戰著	战着
潤著稱	润著称
醯壶	醯壶
閑著述	闲著述
領著者	领著者
考著錄	考著录
蒙著书	蒙著书
玀	猡
殤	殇
高著名	高著名
渴著书	渴著书
打印	打印
躚	跹
貞著者	贞著者
鍠	锽
刻著者	刻著者
鍥	锲
功能變數名稱	域名
鍩	锘
磣	碜
係	系
躦	躜
鍵	键
忍著稱	忍著称
鍶	锶
鍺	锗
悠著錄	悠著录
鍾	钟
鍁	锨
鍀	锝
鍃	锪
應著錄	应著录
鍇	锴
鍆	钔
鍈	锳
音效卡	声卡
鍊	炼
據著名	据著名
鍔	锷
冀著者	冀著者
鍘	铡
鍛	锻
鍚	钖
於志贺	於志贺
綁著名	绑著名
綈	绨
綉	绣
臨	临
綌	绤
綃	绡
轉著者	转著者
仗著名	仗著名
綆	绠
藏著称	藏著称
綞	缍
笨豬跳	蹦极跳
綜	综
經	经
綐	䌼
乾统	乾统
罩著录	罩著录
乾络	乾络
綫	线
綯	绹
綬	绶
維	维
綢	绸
綣	绻
綠	绿
綺	绮
綻	绽
綸	纶
綹	绺
綾	绫
綿	绵
綽	绰
變著者	变著者
綳	绷
麗著書	丽著书
綱	纲
綴	缀
綵	彩
枕著录	枕著录
乾台	乾台
哭著称	哭著称
卡佩雅蒂	珍妮弗·卡普里亚蒂
猜著錄	猜著录
殞	殒
殘	残
身著书	身著书
定著述	定著述
戴著名	戴著名
殲	歼
殰	㱩
殼	壳
殻	壳
殺	杀
類	类
瞪著录	瞪著录
殯	殡
殮	殓
殭	僵
殫	殚
載著	载着
殨	㱮
額	额
題	题
顏	颜
顎	颚
著驚	着惊
得著書	得著书
顆	颗
關著稱	关著称
顙	颡
願	愿
顛	颠
顔	颜
蘸著作	蘸著作
顓	颛
顒	颙
拉著	拉着
顬	颥
顯	显
顫	颤
顥	颢
顧	顾
顢	颟
浮著錄	浮著录
悠著录	悠著录
看著述	看著述
顴	颧
叫著名	叫著名
顱	颅
顰	颦
顳	颞
忙著書	忙著书
低著書	低著书
衣著述	衣著述
保障著录	保障著录
裹著录	裹著录
持著	持着
著數	着数
滑鼠	鼠标
高著	高着
甜著者	甜著者
心著者	心著者
錦	锦
刻著书	刻著书
錢	钱
錠	锭
錡	锜
錮	锢
錯	错
錫	锡
錨	锚
福士	大众
錶	表
沒	没
努力著錄	努力著录
録	录
錳	锰
走著述	走著述
味著名	味著名
錸	铼
錆	锖
錇	锫
錄	录
跳著述	跳著述
錁	锞
錏	铔
光碟機	光驱
錈	锩
劃	划
開著名	开著名
錕	锟
錒	锕
錐	锥
錟	锬
錚	铮
錛	锛
刻著錄	刻著录
錙	锱
跟著者	跟著者
婁	娄
袞	衮
流著作	流著作
急著	急着
來著錄	来著录
備著者	备著者
隔著作	隔著作
婦	妇
望著者	望著者
婭	娅
坐著称	坐著称
莢	荚
莧	苋
急著錄	急著录
沉著称	沉著称
偷著書	偷著书
波士尼亞赫塞哥維納	波斯尼亚和黑塞哥维那
卽	即
戴著書	戴著书
卻	却
騎著書	骑著书
區	区
穿著者	穿著者
髭著作	髭著作
蓋火鍋	火锅盖帽
阳为乾	阳为乾
協	协
雅著称	雅著称
莖	茎
雜訊	噪声
苦著述	苦著述
鋪著名	铺著名
戴著稱	戴著称
晃著者	晃著者
陋著錄	陋著录
牽	牵
韍	韨
飄著書	飘著书
乾式	乾式
豫著	豫着
附著作	附著作
軟件	软件
慣著	惯着
牘	牍
牆	墙
性著錄	性著录
東	东
鷲	鹫
乾，天也	乾，天也
吶	呐
韃	鞑
燒著述	烧著述
吳	吴
接著作	接著作
刻著录	刻著录
鷿	䴙
宮	宫
當著作	当著作
訶	诃
獲著名	获著名
蘸著錄	蘸著录
閂	闩
著撰	着撰
閃	闪
吒	咤
閌	闶
語著	语着
鷹	鹰
拉著录	拉著录
夾著述	夹著述
附著稱	附著称
跳著書	跳著书
籌	筹
關著者	关著者
乾紅	乾红
籃	篮
閉	闭
籟	籁
籜	箨
閉著	闭着
籙	箓
制著称	制著称
乾紐	乾纽
抓著	抓着
騙著者	骗著者
訣	诀
籬	篱
籪	簖
籩	笾
拼著作	拼著作
潤著述	润著述
籤	签
瑽	𪻐
籠	笼
壩	坝
急著称	急著称
側著者	侧著者
在著者	在著者
籲	吁
信著述	信著述
畢	毕
躍著錄	跃著录
伴著者	伴著者
閒	闲
畫	画
異	异
殺著作	杀著作
當	当
畵	画
聽著書	听著书
孤著錄	孤著录
關著錄	关著录
志著述	志著述
扛著書	扛著书
扛著述	扛著述
有著书	有著书
心著述	心著述
努力著書	努力著书
渴著書	渴著书
鋃	锒
含著书	含著书
畝	亩
頒	颁
閤	合
預	预
瞪著书	瞪著书
頗	颇
訒	讱
領	领
頜	颌
頂	顶
頃	顷
乾巛	乾巛
頁	页
順	顺
頇	顸
乾州	乾州
頊	顼
著姓	着姓
須	须
頎	颀
頏	颃
頌	颂
閡	阂
頲	颋
頰	颊
呂	吕
頷	颔
頴	颕
鐙	镫
頻	频
頸	颈
頹	颓
背著称	背著称
頽	颓
櫪	枥
閬	阆
拚	拼
頡	颉
頦	颏
頤	颐
以微知著	以微知著
衣著称	衣著称
溢著書	溢著书
頭	头
爲	为
住著称	住著称
昂著者	昂著者
爾	尔
朝著述	朝著述
爺	爷
盛著錄	盛著录
因數	因子
爭	争
閑著作	闲著作
走著名	走著名
戀著者	恋著者
側著	侧着
遇著作	遇著作
閶	阊
爛	烂
找不著	找不着
爍	烁
悠著	悠着
追著称	追著称
扎著述	扎著述
況	况
因著書	因著书
乾象历	乾象历
乾启	乾启
頂著名	顶著名
去著录	去著录
閽	阍
錩	锠
泝	溯
郵	邮
閿	阌
亮著书	亮著书
乾吉	乾吉
討	讨
夾著稱	夹著称
郟	郏
背著者	背著者
昭著	昭著
爭著	争着
睡著	睡着
閻	阎
沖	冲
抱著称	抱著称
獲著稱	获著称
毆	殴
乾錄	乾录
嚷著书	嚷著书
餛	馄
紈	纨
見著書	见著书
海珊	侯赛因
乾化	乾化
毿	毵
味著录	味著录
罩著	罩着
盾著录	盾著录
豎著者	竖著者
遇著者	遇著者
匯	汇
開著稱	开著称
華	华
制著作	制著作
菴	庵
演著称	演著称
射門	打门
備著稱	备著称
匱	匮
提著称	提著称
想著录	想著录
蒙著述	蒙著述
矽钢	矽钢
隨著書	随著书
陋著录	陋著录
滿16進位	满16进位
拿著稱	拿著称
蘸著述	蘸著述
駕	驾
駔	驵
戩	戬
駒	驹
駑	驽
駐	驻
駟	驷
駝	驼
餉	饷
駛	驶
駙	驸
駘	骀
追著述	追著述
亮著名	亮著名
列支敦斯登	列支敦士登
馬利共和國	马里共和国
見著錄	见著录
駁	驳
背著錄	背著录
戶	户
矽塵	矽尘
戰	战
戲	戏
駱	骆
駰	骃
駿	骏
美著作	美著作
戇	戆
駻	𫘣
戀	恋
耀著書	耀著书
駸	骎
浮著书	浮著书
駢	骈
駡	骂
乾盛世	乾盛世
著妳	着妳
照著名	照著名
麗著稱	丽著称
頂著述	顶著述
唱著書	唱著书
乾衡	乾衡
打印機	打印机
扛著名	扛著名
雜著	杂着
幹著	干着
掖著	掖着
循著书	循著书
住著述	住著述
蛻	蜕
鋪著書	铺著书
乾行	乾行
附著称	附著称
冒著录	冒著录
錘	锤
餷	馇
志著	志着
乾轴	乾轴
吹著录	吹著录
餿	馊
娛	娱
補	补
裝	装
候著書	候著书
乾车	乾车
高著書	高著书
裊	袅
仗著述	仗著述
換	换
裏	里
樊於期	樊於期
製	制
裡	里
膠著名	胶著名
涼著	凉着
侏儸紀	侏罗纪
落著	落着
求著称	求著称
產	产
産	产
甦	苏
晃著作	晃著作
康著作	康著作
烏茲別克	乌兹别克斯坦
無	无
甯	宁
斗著称	斗著称
逆著者	逆著者
彷彿	仿佛
福著名	福著名
陳乾生	陈乾生
走著錄	走著录
踏著	踏着
𡻕	岁
甌	瓯
甕	瓮
光著者	光著者
持著述	持著述
孤著稱	孤著称
守著称	守著称
努著称	努著称
勩	勚
耬	耧
愛著作	爱著作
寫著稱	写著称
勢	势
據著者	据著者
勻	匀
勸	劝
鍛鍾	锻锺
關著作	关著作
勳	勋
勱	劢
困著录	困著录
盯著稱	盯著称
獨著錄	独著录
勁	劲
盧安達	卢旺达
王道乾	王道乾
勝	胜
勛	勋
務	务
動	动
雜著作	杂著作
狹	狭
信著	信着
著處	着处
學著述	学著述
性著書	性著书
涼著稱	凉著称
著號	着号
互動式	交互式
連著者	连著者
債	债
跪著	跪着
暗著作	暗著作
努著書	努著书
踏著录	踏著录
盡	尽
耀著錄	耀著录
狀	状
馬爾他	马耳他
簍	篓
溢著名	溢著名
簀	箦
譾	谫
簞	箪
數著名	数著名
鉑	铂
寫著名	写著名
簑	蓑
乾栋	乾栋
豫著称	豫著称
纏著者	缠著者
簫	箫
潤著名	润著名
乾絡	乾络
黏著录	黏著录
嚷著書	嚷著书
簣	篑
簽	签
簾	帘
簹	筜
沉著书	沉著书
冒著名	冒著名
頂著書	顶著书
黃	黄
駕著述	驾著述
鉞	钺
輸	输
欞	棂
欒	栾
沈沒	沉没
黌	黉
笑著名	笑著名
欏	椤
借著作	借著作
掖著錄	掖著录
扎著书	扎著书
欅	榉
乾卦	乾卦
向著录	向著录
欽	钦
掖著者	掖著者
向著名	向著名
做著稱	做著称
留著名	留著名
側著錄	侧著录
黲	黪
譯	译
「	“
」	”
『	‘
』	’
丑著作	丑著作
黿	鼋
愛著錄	爱著录
黽	黾
鉀	钾
多米尼克	多米尼加国
代表著述	代表著述
痠	酸
壓著錄	压著录
拖著作	拖著作
領著錄	领著录
金鍊	金链
耀著者	耀著者
抬著名	抬著名
痾	疴
低著者	低著者
陋著者	陋著者
鉉	铉
吃得著	吃得着
乾皋	乾皋
孤著称	孤著称
著腳	着脚
隔著述	隔著述
斗著述	斗著述
痙	痉
福著述	福著述
譜	谱
對著者	对著者
盛著述	盛著述
喝著名	喝著名
著帳	着帐
配著录	配著录
馴	驯
馱	驮
馳	驰
繞著書	绕著书
馹	驲
偷著述	偷著述
因著录	因著录
數著作	数著作
豎著述	竖著述
努力著者	努力著者
抱著作	抱著作
馬	马
馭	驭
馮	冯
漫著名	漫著名
氂	牦
氌	氇
氈	毡
鉸	铰
嚷著者	嚷著者
乾命	乾命
後姓	後姓
領著稱	领著称
鉺	铒
戀著錄	恋著录
邊	边
猜著者	猜著者
氣	气
邏	逻
刻著稱	刻著称
還	还
氫	氢
乾马	乾马
鉦	钲
氳	氲
候著名	候著名
邐	逦
著錄規則	著录规则
含著稱	含著称
傳著作	传著作
嶄	崭
褘	袆
複	复
見著	见着
拿著者	拿著者
望著錄	望著录
靠著者	靠著者
鉬	钼
幺舅	幺舅
本著称	本著称
光著录	光著录
代表著稱	代表著称
褳	裢
褲	裤
褻	亵
褸	褛
漁	渔
嚷著錄	嚷著录
睡著者	睡著者
鍊子	链子
釣	钓
苦著者	苦著者
姦	奸
歟	欤
米澤瑠美	米泽瑠美
莊	庄
笑著书	笑著书
著地	着地
歐	欧
鋦	锔
歎	叹
光著称	光著称
麗	丽
當著	当着
鎖鍊	锁链
歿	殁
麥	麦
歸	归
敞著者	敞著者
歷	历
麪	面
麫	面
歲	岁
麯	曲
麴	曲
麵	面
哭著作	哭著作
牽著書	牵著书
麼	么
麽	么
逼著稱	逼著称
歡	欢
嗅著	嗅着
聯	联
聹	聍
寫著錄	写著录
聽	听
聾	聋
因著稱	因著称
聰	聪
據著述	据著述
聲	声
聳	耸
聵	聩
聶	聂
職	职
劌	刿
劍	剑
諾魯	瑙鲁
劏	㓥
蒙著称	蒙著称
空著称	空著称
劊	刽
瞧著名	瞧著名
本著書	本著书
踩著	踩着
劇	剧
睡著書	睡著书
釀著者	酿著者
挑著作	挑著作
軍中樂園	军中乐园
淥	渌
劑	剂
聖	圣
行著称	行著称
飄著	飘着
踐	践
志著名	志著名
釘	钉
挑著錄	挑著录
潤著作	润著作
保障著作	保障著作
甜著書	甜著书
住著者	住著者
數據機	调制解调器
響著	响着
嶽	岳
釁	衅
糝	糁
糞	粪
行著	行着
空著作	空著作
𡞵	㛟
跪著錄	跪著录
印著書	印著书
鉸鍊	铰链
糰	团
點	点
糲	粝
糴	籴
糶	粜
糹	纟
桌球	台球
糾	纠
低著名	低著名
糧	粮
䱽	䲝
乾綱	乾纲
趴著書	趴著书
襖	袄
妝	妆
披著	披着
襝	裣
枕著	枕着
襆	幞
襇	裥
襀	𫌀
襏	袯
耀著书	耀著书
鋭	锐
響著者	响著者
襲	袭
忙著书	忙著书
仰屋著書	仰屋著书
佛頭著糞	佛头著粪
襠	裆
披著称	披著称
膃	腽
襬	䙓
襯	衬
襪	袜
考著书	考著书
貞著書	贞著书
幺麽	幺麽
遺著	遗著
仗著作	仗著作
項鍊	项链
廚	厨
疊	叠
鸚	鹦
壓著者	压著者
向著稱	向著称
疇	畴
行著名	行著名
豫著者	豫著者
猜著	猜着
試著述	试著述
擴	扩
扎著者	扎著者
毛里裘斯	毛里求斯
擷	撷
順著者	顺著者
對著書	对著书
犧	牺
犢	犊
演著錄	演著录
撼著錄	撼著录
看著称	看著称
燒著	烧着
乾上乾下	乾上乾下
犖	荦
隨著者	随著者
渴著作	渴著作
想著称	想著称
照著稱	照著称
浮著	浮着
寮國	老挝
適	适
廈	厦
遡	溯
遠	远
遼	辽
努著作	努著作
冷盤	凉菜
選	选
遺	遗
乾首	乾首
擄	掳
含著者	含著者
急著書	急著书
遲	迟
滿十進位	满十进位
乾馬	乾马
過	过
志著称	志著称
斗著書	斗著书
運	运
遊	游
隨著稱	随著称
拖著称	拖著称
趴著名	趴著名
決	决
遜	逊
遞	递
附著录	附著录
違	违
達	达
擋著作	挡著作
昂著作	昂著作
著迷	着迷
背著书	背著书
著述	著述
拿著名	拿著名
挨著錄	挨著录
靠著名	靠著名
執著	执著
候著者	候著者
記著書	记著书
夾著作	夹著作
點著名	点著名
膠著書	胶著书
冀著	冀着
猜著書	猜着书
粵	粤
罵著述	骂著述
跪著者	跪著者
高著錄	高著录
著然	着然
檔	档
拎著录	拎著录
撣	掸
走著者	走著者
撥	拨
撫	抚
撳	揿
撲	扑
鋪著者	铺著者
藏著	藏着
撻	挞
晃著名	晃著名
撿	捡
據	据
領著述	领著述
撈	捞
撏	挦
鹵	卤
樂著名	乐著名
撐	撑
拖著者	拖著者
光著述	光著述
鹽	盐
鹼	碱
撟	挢
據著錄	据著录
撝	㧑
鹺	鹾
饘	𫗴
饜	餍
演著述	演著述
饞	馋
饑	饥
饒	饶
饗	飨
饉	馑
饈	馐
饋	馈
饊	馓
饌	馔
採	采
饁	馌
布殊	布什
饅	馒
掗	挜
乾泉	乾泉
唱著书	唱著书
遇著	遇着
代表著名	代表著名
掛	挂
掙	挣
寫著	写着
洗鍊	洗练
衣著稱	衣著称
掃	扫
醯鸡	醯鸡
壓著稱	压著称
饢	馕
機械人	机器人
疑著书	疑著书
蹌	跄
龕	龛
踩著录	踩著录
蹕	跸
忌廉	奶油
藝著	艺着
著摸	着摸
高著书	高著书
睹微知著	睹微知著
蹣	蹒
蹤	踪
沿著書	沿著书
柳诒徵	柳诒徵
別	别
有著稱	有著称
猜著稱	猜著称
蹺	跷
蹻	𫏋
藝著錄	艺著录
因著作	因著作
進	进
週	周
涇	泾
站著作	站著作
連	连
麗著者	丽著者
曠若發矇	旷若发矇
拖著錄	拖著录
求著書	求著书
跪著名	跪著名
這	这
鶖	鹙
醯雞	醯鸡
涼	凉
戀著稱	恋著称
縭	缡
千里達托貝哥	特立尼达和托巴哥
忙著名	忙著名
覘	觇
展著者	展著者
覓	觅
心著錄	心著录
忙著作	忙著作
合著	合著
視	视
見	见
跟著書	跟著书
規	规
覎	觃
盾著書	盾著书
隨著	随着
流著书	流著书
奼	姹
膠著述	胶著述
覺	觉
覽	览
覼	𫌨
覿	觌
茅利塔尼亞	毛里塔尼亚
覲	觐
戰著者	战著者
覷	觑
拖著述	拖著述
奬	奖
親	亲
奩	奁
覬	觊
覯	觏
奪	夺
覡	觋
奧	奥
銀鍊	银链
覥	觍
覦	觎
關著述	关著述
載著名	载著名
頓	顿
創	创
剴	剀
剷	铲
著績	着绩
康著	康着
漫著書	漫著书
瓜地馬拉	危地马拉
剮	剐
剗	刬
肅	肃
剛	刚
剝	剥
勞	劳
急著名	急著名
剄	刭
則	则
身著錄	身著录
剋	克
剎	刹
挑著稱	挑著称
轉著作	转著作
待著名	待著名
易·乾	易·乾
髭著书	髭著书
趴著述	趴著述
显著	显著
達著錄	达著录
追著稱	追著称
憶	忆
鶇	鸫
梵谷	凡高
躂	跶
躍	跃
滿八進位	满八进位
躉	趸
躋	跻
夾著錄	夹著录
躕	蹰
留著者	留著者
躑	踯
躓	踬
躒	跞
順著稱	顺著称
布基納法索	布基纳法索
敞著作	敞著作
躥	蹿
吹著书	吹著书
留著称	留著称
皺著者	皱著者
躡	蹑
保障著述	保障著述
制著錄	制著录
躪	躏
身著書	身著书
附睪	附睾
追著錄	追著录
漫著述	漫著述
䊷	䌶
籮	箩
撞球	台球
罈	坛
罎	坛
罌	罂
沿著	沿着
迦納	加纳
魺	鲄
幺蛾子	幺蛾子
罰	罚
罷	罢
罵	骂
字元濟	字元济
流露著	流露着
戀著述	恋著述
曉	晓
滿十六進位	满十六进位
叫著錄	叫著录
瑪	玛
瑩	莹
坐著名	坐著名
去著称	去著称
瑣	琐
代表著	代表着
候著作	候著作
乾男	乾男
瑲	玱
快閃記憶體	快闪存储器
瑋	玮
釀著名	酿著名
困著書	困著书
轉著書	转著书
庇護著	庇护着
身著名	身著名
瑒	玚
餞	饯
餜	馃
餚	肴
朝著录	朝著录
餘	余
餖	饾
餗	𫗧
餔	𫗦
餕	馂
餒	馁
餓	饿
餑	饽
餎	饹
餏	饻
餌	饵
養	养
修鍊	修炼
餄	饸
餅	饼
餃	饺
餾	馏
照著書	照著书
餼	饩
豎著作	竖著作
餺	馎
餶	馉
笑著称	笑著称
餵	喂
印著称	印著称
互聯網	互联网
餱	糇
罵著書	骂著书
揀	拣
館	馆
餦	𫗠
皺著名	皱著名
餡	馅
乾笃	乾笃
陈乾生	陈乾生
資訊理論	信息论
尋著書	寻著书
連著述	连著述
言幾析理	言幾析理
罵著稱	骂著称
乾符	乾符
攪	搅
得著者	得著者
騙著書	骗著书
盯著	盯着
有著录	有著录
當著名	当著名
管著述	管著述
忙著稱	忙著称
低著述	低著述
待著述	待著述
寫著作	写著作
釷	钍
釵	钗
附著書	附著书
踏著作	踏著作
漫著称	漫著称
釺	钎
釹	钕
釧	钏
點著者	点著者
釤	钐
向著述	向著述
淚	泪
淒	凄
麽氏	麽氏
釗	钊
釕	钌
釔	钇
淨	净
淩	凌
淪	沦
釐	厘
幫著	帮着
針	针
在著录	在著录
落著者	落著者
釙	钋
帶著作	带著作
鳳	凤
釅	酽
釃	酾
淺	浅
釀	酿
悠著述	悠著述
淵	渊
淶	涞
釋	释
保障著称	保障著称
展著书	展著书
擠	挤
鸋	𫛢
鸏	鹲
鸌	鹱
鸂	㶉
鳷	𫛛
擬	拟
鸇	鹯
擯	摈
擰	拧
擱	搁
鸘	鹴
抱著录	抱著录
鸞	鸾
麗著作	丽著作
鸝	鹂
擺	摆
擻	擞
擼	撸
擾	扰
鸕	鸬
擁	拥
借著录	借著录
擇	择
擊	击
擋	挡
鳩	鸠
蝦	虾
擓	㧟
擔	担
乾鈞	乾钧
因著錄	因著录
皺著錄	皱著录
貝南	贝宁
制著书	制著书
點著錄	点著录
與著作	与著作
朝著	朝着
據著作	据著作
刪	删
壓著書	压著书
梳著作	梳著作
雅著稱	雅著称
闓	闿
盛著書	盛著书
挑著	挑着
碕	埼
坤乾	坤乾
點陣圖	位图
難	难
離	离
駕著錄	驾著录
挾	挟
挱	挲
冒著述	冒著述
繞著者	绕著者
挩	捝
雲	云
苧烯	苧烯
電	电
字元會	字元会
拿破崙	拿破仑
浮著作	浮著作
軑	轪
曇	昙
雋	隽
唱著	唱着
遇著錄	遇著录
雖	虽
閑著名	闲著名
雛	雏
贓	赃
雙	双
雞	鸡
雜	杂
車	车
軋	轧
乾音	乾音
鈑	钣
軏	𫐄
軌	轨
軍	军
麗著名	丽著名
軀	躯
贐	赆
軛	轭
軟	软
軒	轩
留著述	留著述
溫納圖	瓦努阿图
涼著錄	凉著录
軔	轫
軫	轸
軨	𫐉
想著書	想著书
穿著述	穿著述
笑著者	笑著者
軺	轺
軻	轲
軸	轴
鈉	钠
軾	轼
軼	轶
軲	轱
捆著稱	捆著称
義大利	意大利
夢	梦
走著書	走著书
夠	够
努著稱	努著称
行動電話	移动电话
忙著述	忙著述
幺小	幺小
聞著	闻着
披著者	披著者
华乐	民乐
頑	顽
軤	轷
站著称	站著称
靠著述	靠著述
驚	惊
夾	夹
觀	观
味著者	味著者
觸	触
觶	觯
苦著書	苦著书
藏著稱	藏著称
求著者	求著者
瞧著述	瞧著述
軹	轵
孤著录	孤著录
擺著述	摆著述
冒著稱	冒著称
打著	打着
鋪著述	铺著述
夾著名	夹著名
字型檔	字库
慣	惯
吹著稱	吹著称
驍	骁
琿	珲
柳詒徵	柳诒徵
琺	珐
揉著	揉着
驏	骣
傳著稱	传著称
試著作	试著作
乘著称	乘著称
打著者	打著者
落著書	落著书
矓	眬
六進位	六进制
遇著书	遇著书
嶔	嵚
踩著書	踩著书
落著稱	落著称
凱	凯
項	项
脹	胀
梳著者	梳著者
康著稱	康著称
脣	唇
用得著	用得着
脫	脱
笑著稱	笑著称
凙	𪞝
管著称	管著称
凜	凛
乾一组	乾一组
夥	伙
脛	胫
涼著作	凉著作
哭著書	哭著书
在著	在着
脅	胁
凈	净
凍	冻
掙著名	挣著名
刻著作	刻著作
摟著	搂着
脈	脉
熗	炝
等於	等于
乾策	乾策
流著錄	流著录
躺著	躺着
殺著名	杀著名
悠著称	悠著称
望著	望着
肘手鍊足	肘手链足
展著录	展著录
皺著稱	皱著称
漫著錄	漫著录
幺篇	幺篇
藉由	借由
踏著者	踏著者
䋻	䌾
鍾鍛	锺锻
做著录	做著录
逼著名	逼著名
扎著	扎着
含著	含着
穿著称	穿著称
演著作	演著作
戴著书	戴著书
美著录	美著录
領著作	领著作
䋙	䌺
空著录	空著录
孌	娈
鐍	𫔎
空著述	空著述
盛著录	盛著录
搵	揾
罵著名	骂著名
搶	抢
丑著书	丑著书
乾鉴	乾鉴
鞽	鞒
損	损
頮	颒
秈	籼
搗	捣
搖	摇
豫著书	豫著书
揮著述	挥著述
觴	觞
穀梁	穀梁
抬著錄	抬著录
捆著名	捆著名
涵著作	涵著作
撼著者	撼著者
裝著錄	装著录
穿著書	穿著书
著聞	着闻
魏徵	魏徵
仗著录	仗著录
嶮	崄
披著录	披著录
瓚	瓒
優先順序	优先级
於戲	於戏
照著	照着
吳其濬	吴其濬
獲著	获着
循著述	循著述
瓊	琼
瓏	珑
當著稱	当著称
膠著稱	胶著称
南韓	韩国
隨	随
險	险
捲	卷
提著名	提著名
躍著	跃着
騎著名	骑著名
落著作	落著作
隴	陇
捫	扪
捨	舍
學著稱	学著称
隸	隶
隻	只
應著	应着
隉	陧
隊	队
響著錄	响著录
階	阶
動著錄	动著录
隕	陨
於潜县	於潜县
代表著录	代表著录
際	际
留著錄	留著录
逆著名	逆著名
陪著录	陪著录
醱	酦
話	话
黏著作	黏著作
駕著書	驾著书
殺著書	杀著书
拼著	拼着
醣	糖
醬	酱
醯	酰
醫	医
醖	酝
蓋亞那	圭亚那
醜	丑
苦著称	苦著称
醞	酝
乾啟	乾启
映著名	映著名
懷著名	怀著名
洩	泄
喝著述	喝著述
盯著录	盯著录
蘢	茏
著槁	着槁
壢	坜
壠	垅
壯	壮
殺著稱	杀著称
隔著书	隔著书
蘭	兰
蘺	蓠
壽	寿
著者	著者
蘿	萝
壺	壶
壇	坛
蘇	苏
蘆	芦
五箇山	五箇山
蘄	蕲
蘋	苹
蘊	蕴
壋	垱
壈	𡒄
壓	压
低著	低着
來著述	来著述
蘚	藓
待著者	待著者
壜	坛
蘞	蔹
新著	新著
壘	垒
努著名	努著名
龍	龙
龎	厐
吹著者	吹著者
摯	挚
低著作	低著作
摺	折
摻	掺
枕著名	枕著名
帶著	带着
龔	龚
摳	抠
摶	抟
龑	䶮
笑著作	笑著作
么二三	幺二三
受著录	受著录
著格	着格
詭	诡
陪著名	陪著名
摟	搂
摜	掼
𧩙	䜥
摑	掴
持著稱	持著称
屓	屃
閑著稱	闲著称
制著	制着
慼	戚
腳	脚
矽谷	硅谷
腸	肠
踏著述	踏著述
嚷著述	嚷著述
腦	脑
戀著作	恋著作
腡	脶
挨著者	挨著者
與著述	与著述
含著書	含著书
冷菜	凉菜
腫	肿
腖	胨
做著作	做著作
困著	困着
亮著書	亮著书
腎	肾
候著稱	候著称
待著作	待著作
老幺	老幺
著末	着末
輊	轾
載	载
輈	辀
輇	辁
輅	辂
較	较
輟	辍
輞	辋
輝	辉
輜	辎
輛	辆
輗	𫐐
努著者	努著者
輕	轻
輔	辅
輓	挽
輒	辄
輯	辑
著有	著有
輬	辌
輪	轮
輩	辈
輦	辇
輥	辊
輿	舆
輾	辗
輻	辐
點著述	点著述
趕著作	赶著作
輳	辏
守著述	守著述
急著稱	急著称
黏著者	黏著者
習	习
渾	浑
隨著作	随著作
著身	著身
譯著	译著
聽著	听着
乾精	乾精
翹	翘
著白	着白
保障著书	保障著书
敞著	敞着
甜著	甜着
硬體	硬件
詎	讵
豫著書	豫著书
帶著者	带著者
鋪著作	铺著作
孤著書	孤著书
樂著稱	乐著称
墮	堕
滿二進位	满二进位
虯	虬
墰	坛
撼著書	撼著书
墳	坟
辦著書	办著书
墻	墙
乾鑒	乾鉴
虆	蔂
飄著名	飘著名
耀著作	耀著作
墊	垫
著花	着花
快速面	方便面
著聲	着声
處	处
受著书	受著书
墜	坠
虛	虚
虜	虏
萬曆	万历
尼日利亚	尼日利亚
去著稱	去著称
尼日利亞	尼日利亚
環	环
巴貝多	巴巴多斯
璽	玺
跟著书	跟著书
璦	瑷
璣	玑
護著書	护著书
靠著作	靠著作
當著者	当著者
著肉	着肉
衣著录	衣著录
渦	涡
穿著	穿着
扛著	扛着
捆著錄	捆著录
喝著者	喝著者
璉	琏
載著錄	载著录
順著	顺着
冀著稱	冀著称
候著錄	候著录
感測	传感
昂著書	昂著书
專著	专著
定著录	定著录
獲著者	获著者
麗著	丽着
逼著录	逼著录
葯	药
性著称	性著称
空著名	空著名
著要	着要
盃	杯
映著述	映著述
安地卡及巴布達	安提瓜和巴布达
捆著录	捆著录
映著	映着
柯林頓	克林顿
鍬	锹
活著录	活著录
連著作	连著作
應著述	应著述
鐨	镄
肯雅	肯尼亚
疑著录	疑著录
浹	浃
酈	郦
麴英	麴英
拖著	拖着
乾風	乾风
踏著书	踏著书
努著书	努著书
酇	酂
雜著名	杂著名
黃潤乾	黄润乾
羥	羟
羨	羡
住著稱	住著称
塞普勒斯	塞浦路斯
留著	留着
嚷著作	嚷著作
拚命	拚命
厄瓜多	厄瓜多尔
羆	罴
羅	罗
羋	芈
陳公乾生	陈公乾生
行著書	行著书
關著書	关著书
摟著述	搂著述
齒	齿
齕	龁
齔	龀
齗	龂
齙	龅
溢著称	溢著称
齜	龇
齟	龃
於	于
齇	齄
斷	断
閑著者	闲著者
齊	齐
齏	齑
齎	赍
齲	龋
戰著述	战著述
齷	龌
齶	腭
斃	毙
斂	敛
齡	龄
齠	龆
齣	出
齦	龈
變著錄	变著录
斕	斓
齪	龊
齬	龉
陋著称	陋著称
唱著作	唱著作
陣	阵
冒著作	冒著作
乾龍	乾龙
渴著录	渴著录
拎著者	拎著者
夢著者	梦著者
乾构	乾构
陰	阴
陳	陈
行著錄	行著录
陽	阳
定著書	定著书
陸	陆
乾龙	乾龙
學著書	学著书
乾律	乾律
打著称	打著称
帶著述	带著述
乾枢	乾枢
陝	陕
陞	升
達著書	达著书
陘	陉
蔘	参
轍	辙
轎	轿
轉	转
陪著稱	陪著称
轄	辖
轅	辕
轆	辘
轀	辒
梳著录	梳著录
轂	毂
冀著称	冀著称
朝著作	朝著作
轟	轰
留著作	留著作
轔	辚
做著	做着
斥著書	斥著书
萬事得	马自达
聖馬利諾	圣马力诺
轤	轳
高著作	高著作
藝著稱	艺著称
轡	辔
轢	轹
轣	𫐆
孤著作	孤著作
藉助	借助
學著	学着
峯岸南	峯岸南
乾图	乾图
鄺	邝
溝	沟
躍著者	跃著者
鄶	郐
鄴	邺
六進位制	六进位制
鄲	郸
準	准
信著录	信著录
溈	沩
掖著述	掖著述
鄧	邓
乾风	乾风
亮著录	亮著录
考著者	考著者
鄖	郧
鄔	邬
字乾生	字乾生
鄒	邹
溫	温
瞧著稱	瞧著称
鄉	乡
鄆	郓
躺著作	躺著作
著勁	着劲
冒著者	冒著者
求著录	求著录
塢	坞
狗隻	犬只
塹	堑
逼著書	逼著书
數	数
福著书	福著书
塵	尘
著業	着业
塊	块
塏	垲
冒著称	冒著称
變數	变量
偷著者	偷著者
著極	着极
塒	埘
裝著者	装著者
塗	涂
駕著	驾着
膽	胆
膿	脓
膾	脍
味著书	味著书
候覆	候复
黏著述	黏著述
膩	腻
著邊	着边
困著述	困著述
護著名	护著名
膠	胶
內	内
瞞著者	瞒著者
著惱	着恼
膚	肤
瞪著者	瞪著者
兗	兖
匭	匦
兒	儿
兌	兑
兇	凶
忙著者	忙著者
加彭	加蓬
側著述	侧著述
敗	败
常式	例程
伴著	伴着
乘著書	乘著书
乾篤	乾笃
困著錄	困著录
忙著称	忙著称
光著	光着
看著書	看着书
看得著	看得着
漫著录	漫著录
喝著作	喝著作
么謙	幺谦
落著称	落著称
髭著名	髭著名
味著錄	味著录
求著述	求著述
接著	接着
接著名	接著名
偷著錄	偷著录
拉著錄	拉著录
農	农
尚比亞	赞比亚
耀著	耀着
掙著書	挣著书
遠著作	远著作
乾覆	乾覆
辦	办
冀著述	冀著述
辭	辞
辯	辩
辮	辫
繢	缋
繡	绣
繯	缳
繮	缰
繭	茧
沙烏地阿拉伯	沙特阿拉伯
繪	绘
繩	绳
學著名	学著名
攏	拢
繳	缴
繰	缲
繿	䍀
繾	缱
繽	缤
繼	继
圍著述	围著述
繹	绎
繸	䍁
繆	缪
繅	缫
趕著者	赶著者
繃	绷
著相	着相
紐西蘭	新西兰
連著	连着
繕	缮
織	织
盾著者	盾著者
繒	缯
繐	穗
繞	绕
繚	缭
跑著作	跑著作
幫著書	帮著书
溢著述	溢著述
望著录	望著录
趕著稱	赶著称
向著称	向著称
味著稱	味著称
候著书	候著书
睞	睐
睜	睁
遇著称	遇著称
睏	困
睍	𪾢
唱著稱	唱著称
纏著稱	缠著称
忍著	忍着
乾忠	乾忠
叫著述	叫著述
著實	着实
抬著述	抬著述
二極管	二极管
絎	绗
空著書	空著书
鯷	鳀
流著名	流著名
管著	管着
缽	钵
乾心	乾心
因著述	因著述
載著述	载著述
纏著述	缠著述
敞著述	敞著述
配著书	配著书
於梨華	於梨华
趕著述	赶著述
儂	侬
儀	仪
絕	绝
抬著作	抬著作
儈	侩
儉	俭
代表著書	代表著书
䲁	鳚
儐	傧
乾崗	乾岗
乾天也	乾天也
儔	俦
儕	侪
儘	尽
償	偿
優	优
扎著書	扎著书
抱著錄	抱著录
試著名	试著名
鍊條	链条
陋著稱	陋著称
儺	傩
鍋	锅
帛琉	帕劳
戧	戗
儼	俨
叫著書	叫著书
背著稱	背著称
滙	汇
志著书	志著书
展著作	展著作
逆著作	逆著作
記憶體	内存
滌	涤
變著書	变著书
滎	荥
應著作	应著作
滅	灭
幺二三	幺二三
滸	浒
滻	浐
幾內亞比索	几内亚比绍
著力	着力
滿	满
滲	渗
掙著述	挣著述
備著名	备著名
乾嘉	乾嘉
滬	沪
鍍	镀
滯	滞
駃	𫘝
鸛	鹳
資料庫	数据库
藏著书	藏著书
活著書	活著书
罩著书	罩著书
鼕	冬
噠	哒
隨著述	随著述
裝著作	装著作
旣	既
飄著錄	飘著录
鼉	鼍
皺著書	皱著书
鼴	鼹
戱	戯
鋪著錄	铺著录
旂	旗
呼幺喝六	呼幺喝六
榪	杩
睡著述	睡著述
標誌著	标志着
臺	台
去著名	去著名
葉門	也门
代表著者	代表著者
慣著述	惯著述
滿六進位	满六进位
乾花	乾花
臥	卧
臢	臜
臠	脔
臟	脏
臚	胪
臘	腊
臏	膑
用著錄	用著录
臍	脐
語著名	语著名
臉	脸
摟著者	搂著者
忍著录	忍著录
聞得著	闻得着
有著作	有著作
響	响
韻	韵
著它	着它
韌	韧
韋	韦
韉	鞯
與著錄	与著录
韆	千
美著者	美著者
因著者	因著者
韁	缰
刻著書	刻著书
韞	韫
韝	鞲
韜	韬
韙	韪
聖露西亞	圣卢西亚
借著書	借著书
著定	着定
韓	韩
披著述	披著述
辦著	办着
著書	著书
定著名	定著名
浮著称	浮著称
達著者	达著者
戔	戋
駭	骇
迴	回
綁著	绑着
甜著錄	甜著录
愛	爱
枕著称	枕著称
摟著作	搂著作
備著書	备著书
堯	尧
貞著作	贞著作
穀	谷
蛺	蛱
裹著者	裹著者
樂著書	乐著书
見著者	见著者
場	场
跑著	跑着
報	报
制著稱	制著称
堊	垩
堅	坚
展著	展着
噓	嘘
沿著錄	沿著录
堝	埚
追著录	追著录
鵠	鹄
堖	垴
刻著名	刻著名
乾乾淨淨	干干净净
眾	众
重覆	重复
涵著書	涵著书
耀著述	耀著述
碟片	盘片
拎著作	拎著作
眥	眦
冀著書	冀著书
眞	真
譴	谴
跟著述	跟著述
扎著錄	扎著录
空著稱	空著称
盯著者	盯著者
乾亨	乾亨
斗著稱	斗著称
挨著述	挨著述
向著者	向著者
身著	身着
著明	着明
持著錄	持著录
么半群	幺半群
覆查	复查
笑著录	笑著录
僅	仅
僂	偻
於世成	於世成
著衣	着衣
僉	佥
戀著書	恋著书
僕	仆
枕著錄	枕著录
僑	侨
藉口	借口
拿著錄	拿著录
僞	伪
幺謙	幺谦
髭著者	髭著者
僥	侥
附著名	附著名
備著述	备著述
味著述	味著述
僨	偾
乾穹	乾穹
鬱姓	鬱姓
朝著称	朝著称
僱	雇
留著稱	留著称
價	价
縧	绦
心著稱	心著称
摟著名	搂著名
縣	县
罵著錄	骂著录
縮	缩
拼著述	拼著述
縫	缝
高著述	高著述
縵	缦
縶	絷
縷	缕
縱	纵
縲	缧
涵著书	涵著书
總	总
績	绩
縹	缥
沉著書	沉著书
於祥玉	於祥玉
跪著書	跪著书
縈	萦
縉	缙
縊	缢
縋	缒
縕	缊
縗	缞
縐	绉
縑	缣
縝	缜
縞	缟
縟	缛
縛	缚
鬍	胡
喝著录	喝著录
著雝	着雝
攣	挛
攢	攒
偷著稱	偷著称
懷著者	怀著者
披著錄	披著录
攬	揽
瓔	璎
懌	怿
鵒	鹆
攔	拦
乾渥	乾渥
攖	撄
攙	搀
鳲	鸤
攛	撺
攝	摄
攜	携
鳴	鸣
豫著作	豫著作
響著述	响著述
攄	摅
本著錄	本著录
攆	撵
藏著錄	藏著录
鳧	凫
鳥	鸟
矽	硅
鑽	钻
回覆	回复
踩著者	踩著者
悠著名	悠著名
矯	矫
沿著名	沿著名
靠著录	靠著录
簡訊	短信
矚	瞩
順著作	顺著作
躺著录	躺著录
背著書	背著书
悠著者	悠著者
配著	配着
丑著名	丑著名
矇	蒙
戰著作	战著作
乾曜	乾曜
鬧	闹
鞦	秋
魎	魉
守著	守着
做著者	做著者
陋著名	陋著名
𡢃	㛠
懸	悬
掙著稱	挣著称
於氏	於氏
乾施	乾施
鞏	巩
纏著作	缠著作
求著稱	求著称
待覆	待复
提著錄	提著录
乾方	乾方
視微知著	视微知著
落著书	落著书
乾录	乾录
演著录	演著录
懷	怀
渙	涣
減	减
性著书	性著书
著重	着重
鬨	哄
刻著述	刻著述
盛著者	盛著者
打著书	打著书
蘸著名	蘸著名
靠著	靠着
披著名	披著名
游標	光标
二進位	二进制
乾顾	乾顾
盾著名	盾著名
冒著錄	冒著录
揮著錄	挥著录
測	测
守著書	守著书
譫	谵
福著書	福著书
得著名	得著名
貞著稱	贞著称
乾顧	乾顾
溢著作	溢著作
著棋	着棋
梳著述	梳著述
持著名	持著名
擺著名	摆著名
鬮	阄
幺廝	幺厮
捱	挨
福著稱	福著称
側著作	侧著作
隱	隐
男為乾	男为乾
蜆	蚬
瞧著者	瞧著者
鱮	𫚈
管著者	管著者
瞧著录	瞧著录
隨著名	随著名
耀著称	耀著称
踩著名	踩著名
乾文	乾文
寫著書	写著书
敵	敌
跳著	跳着
偷著书	偷著书
𧵳	䞌
伴著錄	伴著录
字元济	字元济
戰著錄	战著录
逆著書	逆著书
著你	着你
數著錄	数著录
貞著	贞着
低著录	低著录
敘	叙
嚷著稱	嚷著称
懷著錄	怀著录
牽著	牵着
鞀	鼗
壓著名	压著名
乾淳	乾淳
保障著錄	保障著录
對著	对着
沙芬	马拉特·萨芬
慣著作	惯著作
乘著名	乘著名
展著述	展著述
陪著書	陪著书
待著书	待著书
燒著稱	烧著称
提著作	提著作
著意	着意
定著者	定著者
揉著者	揉著者
管著書	管著书
頂著	顶着
持著录	持著录
奧區	奧区
與著者	与著者
攜帶型	便携式
溢著	溢着
響著名	响著名
幺姓	幺姓
有著称	有著称
吹著名	吹著名
撼著作	撼著作
牽著名	牵著名
幺姨	幺姨
嚷著	嚷着
筴	䇲
衣著錄	衣著录
積架	捷豹
忍著者	忍著者
太空梭	航天飞机
綁著作	绑著作
鞝	绱
甜著名	甜著名
罵著者	骂著者
得著作	得著作
踩著书	踩著书
土庫曼	土库曼斯坦
罩著述	罩著述
閉著作	闭著作
逆著稱	逆著称
馬爾地夫	马尔代夫
徵	征
保障著名	保障著名
徹	彻
斗著名	斗著名
尼日爾	尼日尔
徠	徕
蝸	蜗
復	复
閑著	闲着
唱著名	唱著名
戀著名	恋著名
敞著称	敞著称
徑	径
跪著稱	跪著称
彆	别
從	从
受著作	受著作
蝟	猬
喝著書	喝著书
蝕	蚀
列印	打印
後	后
半形	半角
鉗	钳
備著	备着
乘著书	乘著书
寬頻	宽带
帶著錄	带著录
循著名	循著名
對著名	对著名
味著称	味著称
求著作	求著作
流著录	流著录
暗著者	暗著者
含著称	含著称
亮著	亮着
著莫	着莫
跟著作	跟著作
接著称	接著称
見微知著	见微知著
藏著述	藏著述
犯不著	犯不着
傖	伧
傑	杰
做著書	做著书
斥著名	斥著名
備	备
拎著名	拎著名
逆著錄	逆著录
傢	家
傭	佣
傯	偬
守著稱	守著称
薔	蔷
傴	伛
待著录	待著录
乾窦	乾窦
傷	伤
裝著述	装著述
傳	传
傾	倾
湧	涌
湯	汤
蒙著名	蒙著名
乾健也	乾健也
鬱氏	鬱氏
逼著述	逼著述
行著者	行著者
叫著	叫着
動著書	动著书
髭著書	髭著书
湊	凑
洶	汹
看著作	看著作
湞	浈
因著《	因著《
雜著書	杂著书
坐著者	坐著者
雅著書	雅著书
裝著	装着
髭著述	髭著述
耮	耢
纏	缠
續	续
纍	累
纊	纩
著眼	着眼
纈	缬
挑著者	挑著者
照著錄	照著录
低著书	低著书
纁	𫄸
在著稱	在著称
斥著录	斥著录
辦著者	办著者
纘	缵
纖	纤
纔	才
纓	缨
鱝	鲼
鱟	鲎
夢著述	梦著述
遠程控制	远程控制
鱘	鲟
藏著者	藏著者
鱔	鳝
鱗	鳞
持著者	持著者
擲	掷
石碁镇	石碁镇
暫	暂
慣著稱	惯著称
鱉	鳖
接著錄	接著录
鱅	鳙
暢	畅
朝著名	朝著名
鱂	鳉
暘	旸
著陸	着陆
鱸	鲈
鱺	鲡
辦著名	办著名
鱷	鳄
鱭	鲚
鱯	鳠
暈	晕
貝里斯	伯利兹
考著	考着
鱤	鳡
鱧	鳢
打著名	打著名
鱠	鲙
鱣	鳣
著么	着么
守著录	守著录
么元	幺元
演著名	演著名
印表機	打印机
么麼小丑	幺麽小丑
靦	腼
靨	靥
瞘	眍
瞞	瞒
勵	励
瞜	䁖
抓著作	抓著作
諄	谆
靚	靓
靜	静
瞭	了
來著者	来著者
靂	雳
瞶	瞆
靄	霭
看著者	看著者
靈	灵
瞼	睑
字節	字节
遠著者	远著者
獨著述	独著述
鏨	錾
豔	艳
雅著者	雅著者
𨋢	䢂
豈	岂
保障著者	保障著者
哪吒	哪吒
映著錄	映著录
豎	竖
身著稱	身著称
蒙著錄	蒙著录
演著書	演著书
乾象歷	乾象历
豶	豮
鏢	镖
擺著者	摆著者
乾断	乾断
豬	猪
涼著述	凉著述
幺妹	幺妹
澦	滪
澤	泽
想著书	想著书
澠	渑
澮	浍
變著作	变著作
澩	泶
穿梭機	航天飞机
豎著錄	竖著录
望著稱	望著称
著籍	着籍
條	条
澱	淀
雜著稱	杂著称
躺著书	躺著书
澾	㳠
睡著称	睡著称
尼日尔	尼日尔
澇	涝
澆	浇
壼	壸
朝著錄	朝著录
打著述	打著述
身著述	身著述
龜	龟
澗	涧
揮著者	挥著者
澐	沄
待著	待着
護著作	护著作
在著书	在著书
披著书	披著书
螻	蝼
數著述	数著述
螿	螀
乾城	乾城
彥	彦
盛著稱	盛著称
螢	萤
配著称	配著称
演著	演着
沿著称	沿著称
螮	䗖
溢著书	溢著书
彞	彝
彙	汇
螞	蚂
斗著錄	斗著录
螄	蛳
彌	弥
么篇	幺篇
彎	弯
彈	弹
數著者	数著者
藉詞	借词
蘸著录	蘸著录
銑	铣
𨯅	䥿
狽	狈
批覆	批复
著慌	着慌
繞著稱	绕著称
味著作	味著作
傘	伞
抬著称	抬著称
斗著录	斗著录
高著称	高著称
隔著名	隔著名
偷著	偷着
偉	伟
櫨	栌
循著录	循著录
併	并
么蛾子	幺蛾子
莫三比克	莫桑比克
制著者	制著者
壟	垄
乾竇	乾窦
轉著述	转著述
壞	坏
挨著作	挨著作
信著錄	信著录
喝著书	喝著书
夢著錄	梦著录
苦著稱	苦著称
佔	占
乾竺	乾竺
著裝	着装
壚	垆
偽	伪
壙	圹
佇	伫
佈	布
陋著作	陋著作
偵	侦
側	侧
撼著	撼着
貝	贝
那麽	那麽
貟	贠
貞	贞
貙	䝙
颳	刮
貓	猫
爭著錄	争著录
走著稱	走著称
甜著称	甜著称
貽	贻
乾刘	乾刘
貿	贸
貸	贷
銖	铢
騎著作	骑著作
貴	贵
買	买
貶	贬
忙著錄	忙著录
貳	贰
貲	赀
責	责
貯	贮
販	贩
貨	货
貫	贯
潤著	润着
貧	贫
財	财
負	负
扛著者	扛著者
貢	贡
關著	关着
偷著作	偷著作
撼著述	撼著述
拎著述	拎著述
踩著述	踩著述
祿	禄
見著稱	见著称
幺元	幺元
警戒著	警戒着
櫱	蘖
跑著书	跑著书
戰著稱	战著称
撰著	撰著
困著者	困著者
抓著称	抓著称
頂著稱	顶著称
祘	算
华乐街	华乐街
樂著作	乐著作
循著者	循著者
追著	追着
管著书	管著书
陪著称	陪著称
閉著者	闭著者
隔著錄	隔著录
信著称	信著称
幺爹	幺爹
幺爸	幺爸
受著称	受著称
伴著名	伴著名
傳著書	传著书
夢著名	梦著名
照著者	照著者
迴圈	循环
亮著稱	亮著称
龐	庞
罩著稱	罩著称
裹著書	裹著书
悠著書	悠著书
踏著書	踏著书
喝著	喝着
癇	痫
癆	痨
磁軌	磁道
療	疗
計程車	出租车
乾景	乾景
癉	瘅
霧	雾
乾晷	乾晷
霢	霡
癒	愈
癟	瘪
癘	疠
索馬利亞	索马里
癥	症
癤	疖
𡠹	㛿
癢	痒
癡	痴
癮	瘾
癭	瘿
癬	癣
癩	癞
護著述	护著述
配著作	配著作
乾晖	乾晖
史瓦濟蘭	斯威士兰
跳著称	跳著称
癱	瘫
癰	痈
疑著書	疑著书
響著書	响著书
康著录	康著录
網絡	网络
侶	侣
個	个
倈	俫
顯著	显著
倆	俩
困著称	困著称
巴布亞紐幾內亞	巴布亚新几内亚
倀	伥
開著錄	开著录
乾，健也	乾，健也
提著	提着
倖	幸
貞著名	贞著名
們	们
侖	仑
猜著录	猜著录
語著書	语著书
癥瘕	癥瘕
來	来
濤	涛
跑著名	跑著名
藏著作	藏著作
本著	本着
朝乾夕惕	朝乾夕惕
定著作	定著作
濰	潍
濱	滨
濼	泺
濾	滤
郭子乾	郭子乾
嘜	唛
濺	溅
潤著書	润著书
志著作	志著作
纏著名	缠著名
濁	浊
拉著者	拉著者
濃	浓
唱著錄	唱著录
膠著錄	胶著录
濕	湿
走著	走着
身著录	身著录
戴著	戴着
哭著述	哭著述
濟	济
濘	泞
書	书
鰣	鲥
鰠	鳋
鰤	𫚕
鰥	鳏
藝著者	艺著者
釀著作	酿著作
鰨	鳎
鰩	鳐
鰮	鳁
鰭	鳍
鰲	鳌
枕著述	枕著述
藉着	借着
鰱	鲢
曬	晒
鰷	鲦
鰵	鳘
鰺	鲹
鰻	鳗
鰹	鲣
乾造	乾造
鰼	鳛
鄭	郑
鰃	鳂
大衛碧咸	大卫·贝克汉姆
乾通	乾通
鰈	鲽
鰉	鳇
銃	铳
鰏	鲾
曖	暧
罩著作	罩著作
鰒	鳆
鰓	鳃
鰐	鳄
曏	向
護著者	护著者
曄	晔
鰟	鳑
鰜	鳒
睡不著	睡不着
用著者	用著者
瞧著	瞧着
志著書	志著书
提著者	提著者
定著錄	定著录
去著書	去著书
瞞著述	瞒著述
待著稱	待著称
藉故	借故
含著录	含著录
冪	幂
鉿	铪
向著	向着
裹著錄	裹著录
肯亞	肯尼亚
乾興	乾兴
著他	着他
乾昧	乾昧
醯醬	醯酱
瘂	痖
瘍	疡
醯醢	醯醢
因著〈	因著〈
瘋	疯
瘓	痪
瘞	瘗
盯著名	盯著名
醯醋	醯醋
瘧	疟
瘡	疮
光著作	光著作
戴著称	戴著称
瘮	瘆
乾明	乾明
掃瞄器	扫瞄仪
著令	着令
來著書	来著书
瘺	瘘
瘻	瘘
賢	贤
賣	卖
賠	赔
賡	赓
賦	赋
賧	赕
賤	贱
質	质
賫	赍
蕭乾	萧乾
顆進球	粒入球
賬	账
賭	赌
甜著稱	甜著称
賰	䞐
乾位	乾位
么爸	幺爸
么爹	幺爹
賴	赖
男性爲乾	男性为乾
賺	赚
賻	赙
賾	赜
購	购
賽	赛
賂	赂
賃	赁
賀	贺
賁	贲
資	资
賄	贿
賅	赅
賊	贼
乾統	乾统
賈	贾
性著录	性著录
轉著	转着
丑著述	丑著述
試著者	试著者
賒	赊
賓	宾
賑	赈
語著錄	语著录
用著作	用著作
牽著述	牵著述
賚	赉
賙	赒
賞	赏
賜	赐
變著名	变著名
蟶	蛏
仗著称	仗著称
朝著者	朝著者
蟲	虫
著體	着体
弳	弪
強	强
張	张
沿著稱	沿著称
乾荫	乾荫
蟣	虮
麗著錄	丽著录
蟯	蛲
乾圖	乾图
陽為乾	阳为乾
弒	弑
冊	册
弔	吊
蟄	蛰
耀著稱	耀著称
揮	挥
美著书	美著书
蟈	蝈
受著書	受著书
借著稱	借著称
愛著書	爱著书
苦著名	苦著名
欖	榄
溢著录	溢著录
新著龍虎門	新著龙虎门
隔著者	隔著者
鹹	咸
飣	饤
權	权
渴著稱	渴著称
受著述	受著述
頭槌	头球
騖	骛
飄著者	飘著者
躺著名	躺著名
瞧著作	瞧著作
得著	得着
十進位制	十进位制
飄著作	飘著作
曆	历
濫	滥
護著錄	护著录
心著	心着
語著者	语著者
據著	据着
著想	着想
《易乾	《易乾
纜	缆
欄	栏
平治之乱	平治之乱
打著錄	打著录
側著稱	侧著称
圍著書	围著书
慣著者	惯著者
定址	寻址
燒著者	烧著者
機器人	机器人
慣著書	惯著书
定著稱	定著称
母音	元音
乾祐	乾祐
坐著述	坐著述
筆	笔
鐝	镢
俠	侠
著警	着警
布希	布什
喝著稱	喝著称
埰	采
執	执
浮著書	浮著书
坐著	坐着
俔	伣
埡	垭
聖文森及格瑞那丁	圣文森特和格林纳丁斯
俁	俣
礱	砻
黨	党
陋著	陋着
哥斯大黎加	哥斯达黎加
礦	矿
礪	砺
礫	砾
礬	矾
瞪著称	瞪著称
聽著錄	听著录
礙	碍
陈公乾生	陈公乾生
趴著称	趴著称
礆	硷
黷	黩
來著	来着
礎	础
黶	黡
用著称	用著称
鷦	鹪
鷥	鸶
鱖	鳜
輮	𫐓
鷯	鹩
掙著錄	挣著录
黴	霉
睡著名	睡著名
跳著者	跳著者
鷳	鹇
康著名	康著名
當著書	当著书
鷽	鸴
鱒	鳟
鷺	鹭
逼著称	逼著称
鷸	鹬
鷄	鸡
括弧	括号
持著作	持著作
鷀	鹚
掖著作	掖著作
考著述	考著述
鷊	鹝
鷈	䴘
鷗	鸥
鷖	鹥
鷓	鹧
定著	定着
昇	升
活著名	活著名
想著名	想著名
鷙	鸷
鱈	鳕
借著称	借著称
員	员
攤	摊
斯洛維尼亞	斯洛文尼亚
叫著稱	叫著称
𩶘	䲞
著色	着色
倫	伦
綁	绑
向著錄	向著录
詼	诙
守著者	守著者
釀著述	酿著述
掖著稱	掖著称
努著錄	努著录
睡著录	睡著录
跟著录	跟著录
醯酱	醯酱
憑藉	凭借
乾旦	乾旦
乾冈	乾冈
騍	骒
騂	骍
努力著	努力着
盜	盗
乾鹄	乾鹄
乾鹊	乾鹊
穿著名	穿著名
雅著录	雅著录
沉著名	沉著名
與著	与着
戴著作	戴著作
盪	荡
臨著錄	临著录
疑著者	疑著者
監	监
暗著	暗着
盤	盘
盧	卢
瞞著稱	瞒著称
抬著	抬着
钁	镢
騅	骓
跟著錄	跟著录
於賢德	於贤德
漬	渍
漣	涟
漢	汉
漸	渐
站著述	站著述
亮著述	亮著述
漿	浆
擋著者	挡著者
漲	涨
漵	溆
吃不著	吃不着
心著书	心著书
乾靈	乾灵
得著錄	得著录
暉	晖
在著述	在著述
裹著	裹着
漚	沤
傳著者	传著者
抱著述	抱著述
詡	诩
厄瓜多尔	厄瓜多尔
擋著名	挡著名
考著称	考著称
提著稱	提著称
廳	厅
萵	莴
氬	氩
廬	庐
廩	廪
萬	万
閑著書	闲著书
廣	广
廢	废
廡	庑
流著称	流著称
廟	庙
盛著书	盛著书
廝	厮
塋	茔
肉乾乾	肉干干
活著书	活著书
乾坤	乾坤
亮著錄	亮著录
萊	莱
昂著录	昂著录
易经·乾	易经·乾
臨著稱	临著称
照著书	照著书
廄	厩
萇	苌
廂	厢
廁	厕
鶥	鹛
做著称	做著称
鶡	鹖
順著書	顺著书
鶬	鸧
鶯	莺
鶩	鹜
鶪	䴗
鶴	鹤
揚	扬
銠	铑
鶲	鹟
鶼	鹣
餳	饧
鶿	鹚
鶹	鹠
鶺	鹡
鶻	鹘
鶄	䴖
鐲	镯
涵著录	涵著录
逼著錄	逼著录
去著书	去著书
鶉	鹑
鶊	鹒
渴著述	渴著述
鶗	𫛸
鶒	𫛶
鶓	鹋
哭著	哭着
男性為乾	男性为乾
鶘	鹕
鶚	鹗
時	时
惱	恼
低著称	低著称
晉	晋
惲	恽
得著称	得著称
著急	着急
蒙著者	蒙著者
平治之亂	平治之乱
頂著作	顶著作
丑著稱	丑著称
晝	昼
乾暉	乾晖
吃著	吃着
貞著錄	贞著录
看著名	看著名
高著稱	高著称
記著名	记著名
乘著錄	乘著录
遠著	远着
求著名	求著名
開著者	开著者
點著	点着
有著	有着
吹著錄	吹著录
貪	贪
接著述	接著述
考著書	考著书
扛著称	扛著称
帶著書	带著书
贇	赟
贅	赘
贄	贽
身著者	身著者
贏	赢
遠著稱	远著称
贍	赡
贋	赝
贊	赞
戴著者	戴著者
贈	赠
贗	赝
贖	赎
贔	赑
仗著書	仗著书
配著述	配著述
撼著书	撼著书
贜	赃
贛	赣
騙著名	骗著名
拼著录	拼著录
與著書	与著书
蘸著	蘸着
踩著作	踩著作
進球	入球
穿著稱	穿著称
側著名	侧著名
得著书	得著书
聖克里斯多福及尼維斯	圣基茨和尼维斯
循著錄	循著录
鮺	鲝
硯	砚
乾維	乾维
印著錄	印著录
懷著作	怀著作
嗅不著	嗅不着
騎著	骑着
罩著名	罩著名
哈薩克	哈萨克斯坦
打著稱	打著称
光著名	光著名
幺半群	幺半群
揮著稱	挥著称
葷	荤
綁著稱	绑著称
庫	库
調制解調器	调制解调器
點著作	点著作
葤	荮
葦	苇
愛護著	爱护着
蘇利南	苏里南
虧	亏
葒	荭
控制項	控件
葉	叶
代表著称	代表著称
悠著书	悠著书
銪	铕
達著述	达著述
信著稱	信著称
著積	着积
伴著述	伴著述
據著書	据著书
蒙著書	蒙著书
拿著录	拿著录
晃著稱	晃著称
乘著作	乘著作
駕著稱	驾著称
求著书	求著书
吹著	吹着
閉著稱	闭著称
飭令	飭令
模里西斯	毛里求斯
掖著称	掖著称
帶著名	带著名
披著稱	披著称
寬	宽
易经乾	易经乾
乘著	乘着
著她	着她
著絆	着绊
並	并
墾	垦
丟	丢
瀇	㲿
挨著录	挨著录
垵	埯
美著称	美著称
豐	丰
拼著名	拼著名
十進位	十进制
隨著錄	随著录
盯著述	盯著述
光著錄	光著录
潤	润
卓著	卓著
在著称	在著称
拙著	拙著
潿	涠
志著者	志著者
綁著書	绑著书
潷	滗
潰	溃
爭著述	争著述
照著录	照著录
穿著录	穿著录
跟著名	跟著名
乾隆	乾隆
潁	颍
漫著书	漫著书
張法乾	张法乾
沉著录	沉著录
潛	潜
潙	沩
潔	洁
八進位	八进制
叫著者	叫著者
潑	泼
禿	秃
應著稱	应著称
禰	祢
禱	祷
禪	禅
禮	礼
禡	祃
禦	御
么麼	幺麽
尋著錄	寻著录
禕	祎
康著述	康著述
吃衣著飯	吃衣著饭
裹著稱	裹著称
禎	祯
崑	昆
禍	祸
努著	努着
圍著稱	围著称
鵪	鹌
鵬	鹏
鵯	鹎
鵮	鹐
鵡	鹉
幫著述	帮著述
循著稱	循著称
運算元	算子
么舅	幺舅
鵾	鹍
鵰	雕
鵲	鹊
鵷	鹓
鵁	䴔
鵃	鸼
鵂	鸺
䝼	䞍
繞著錄	绕著录
鵝	鹅
鵜	鹈
鵑	鹃
鵐	鹀
鵓	鹁
即食麵	方便面
掖著名	掖著名
雜著錄	杂著录
鑼	锣
鑿	凿
鑾	銮
鑹	镩
存檔	存盘
鑷	镊
鑱	镵
鑰	钥
開著作	开著作
鑲	镶
鑭	镧
達著名	达著名
皚	皑
懷著書	怀著书
鑥	镥
諾	诺
乾斷	乾断
著位	着位
鑠	铄
鑣	镳
字型大小	字号
鑞	镴
鑕	锧
鑔	镲
裹著作	裹著作
鑑	鉴
鑒	鉴
鑌	镔
悠著作	悠著作
皺	皱
皸	皲
鑊	镬
鑄	铸
諰	𫍰
皰	疱
盯著書	盯着书
纏著書	缠著书
赬	赪
諶	谌
鋝	锊
壓著	压着
芝士	乾酪
摟著稱	搂著称
轉著稱	转著称
豎著書	竖著书
拎著稱	拎著称
寫著者	写著者
邁	迈
諮	咨
塞席爾	塞舌尔
住著作	住著作
梲	棁
努力著称	努力著称
漫著者	漫著者
𫚒	軿
么妹	幺妹
乾乾脆脆	干干脆脆
美著書	美著书
邇	迩
昂著	昂着
側著書	侧著书
斥著者	斥著者
想著作	想著作
掙著者	挣著者
梔	栀
諦	谛
梘	枧
梟	枭
本著述	本著述
璫	珰
飄著述	飘著述
瞞著書	瞒著书
隔著稱	隔著称
著稱	著称
蒼	苍
毀	毁
蒙著稱	蒙著称
活著述	活著述
靠著稱	靠著称
跳著錄	跳著录
串列加速器	串列加速器
鋰	锂
擺著錄	摆著录
聽著述	听著述
領著書	领著书
蒞	莅
沈默	沉默
蒔	莳
諝	谞
蒓	莼
在著作	在著作
挨著	挨着
代表著作	代表著作
光著稱	光著称
黏著书	黏著书
著哩	着哩
諑	诼
跳著作	跳著作
逼著者	逼著者
論	论
蘸著稱	蘸著称
應著者	应著者
藉此	借此
餭	𫗮
印著述	印著述
躍著書	跃著书
㞞	𪨊
抓著稱	抓著称
著庸	着庸
揉著書	揉著书
乾	干
鋤	锄
坐著作	坐著作
颶	飓
笑著錄	笑著录
陋著书	陋著书
鋪	铺
美著稱	美著称
行著稱	行著称
鋯	锆
澀	涩
談	谈
梳著稱	梳著称
受著名	受著名
康著者	康著者
臨著書	临著书
盾著称	盾著称
趨	趋
矽尘	矽尘
姍	姗
鐋	铴
站著者	站著者
鐒	铹
鐓	镦
鐐	镣
乾一坛	乾一坛
鐔	镡
鐘	钟
趲	趱
煉	炼
爐	炉
獲著作	获著作
鐠	镨
褌	裈
鐦	锎
鐧	锏
鐫	镌
解析度	分辨率
鐮	镰
趙	赵
鐳	镭
聽得著	听得着
鐶	镮
鐵	铁
鐺	铛
鐸	铎
趕	赶
鐿	镱
黏著錄	黏著录
昂著錄	昂著录
抓著名	抓著名
迫著	迫着
樂著錄	乐著录
拿著	拿着
硨	砗
硤	硖
硜	硁
閆	闫
於哲	於哲
管著作	管著作
防寫	写保护
映著称	映著称
陳堵	陳堵
硃	朱
幀	帧
幃	帏
制著述	制著述
斗著作	斗著作
散钱	零钱
晃著称	晃著称
對著作	对著作
幗	帼
幘	帻
扎著称	扎著称
幟	帜
牽著者	牵著者
幣	币
幫	帮
幬	帱
伴著称	伴著称
映著書	映著书
幹	干
展著書	展著书
著稿	着稿
幺	么
幾	几
煒	炜
鯰魚	鲶鱼
賓士	奔驰
志著稱	志著称
煙	烟
著己	着己
康著書	康著书
仗著稱	仗著称
吐瓦魯	图瓦卢
黄润乾	黄润乾
附著錄	附著录
吴其濬	吴其濬
雅著名	雅著名
煱	㶽
著便	着便
趕著書	赶著书
乾姓	乾姓
男为乾	男为乾
煢	茕
乾始	乾始
擋著錄	挡著录
煥	焕
捆著者	捆著者
煩	烦
煬	炀
